new_para	deletion
ADJ_AAKKOSELLINEN	nen
ADJ_AAVA	a
ADJ_ABNORMAALI	i
ADJ_ABNORMI	i
ADJ_AHNE
ADJ_AIEMPI	pi
ADJ_AINOA	a
ADJ_AINUT	t
ADJ_ALASTON	n
ADJ_AUTIO
ADJ_AUTUAS	s
ADJ_AVOIN	n
ADJ_BEIGE
ADJ_EHTA	ta
ADJ_EHYT	t
ADJ_GAY
ADJ_HAILAKKA	ka
ADJ_HALPA	pa
ADJ_HAPAN	an
ADJ_HAPERA	a
ADJ_HARMAJA	a
ADJ_HARRAS	ras
ADJ_HELLE	le
ADJ_HIDAS	das
ADJ_HOIKKA	ka
ADJ_HUPAKKO	ko
ADJ_HURTTI	ti
ADJ_HÄPÄISTY
ADJ_HÖLÖ
ADJ_HÖMPPÄ	pä
ADJ_HÖPPÄNÄ	ä
ADJ_IKÄLOPPU	pu
ADJ_JÄREÄ	ä
ADJ_KADE	de
ADJ_KELPO	po
ADJ_KOHELO
ADJ_KOLKKO	ko
ADJ_KOLMAS	s
ADJ_KORKEA	a
ADJ_KULTA	ta
ADJ_KULUNUT	ut
ADJ_KYLMÄJÄRKINEN	nen
ADJ_KYVYTÖN	ön
ADJ_KYYTTÖ	tö
ADJ_KÄYPÄ	pä
ADJ_KÖKKÖ	kö
ADJ_LAKO	ko
ADJ_LATUSKA	a
ADJ_LENKO	ko
ADJ_LÄHEMPI	pi
ADJ_LÄHTEISYYS	s
ADJ_LÄMMIN	min
ADJ_LÄNTÄ	tä
ADJ_LÄTYSKÄ	ä
ADJ_LÖPERÖ
ADJ_LÖRPPÖ	pö
ADJ_MARTO	to
ADJ_MATALA	a
ADJ_MATTA	ta
ADJ_MELTO	to
ADJ_MENTY	ty
ADJ_MIETO	to
ADJ_MUU	u
ADJ_MYKKÄ	kä
ADJ_MÄRKÄ	kä
ADJ_MÄTÄ	tä
ADJ_NELJÄS	s
ADJ_OHUT	t
ADJ_OIKEE	e
ADJ_OPAAKKI	ki
ADJ_PAHIN	n
ADJ_PANTU	tu
ADJ_PARANNELTU	tu
ADJ_PARAS	as
ADJ_PEEAA	a
ADJ_PIENI	i
ADJ_PIERTY	ty
ADJ_PINKKI	ki
ADJ_PITKÄ	tkä
ADJ_POHATTA	ta
ADJ_POPPA	pa
ADJ_PURTU	tu
ADJ_RAAKA	ka
ADJ_RAITIS	is
ADJ_RAMPA	pa
ADJ_REHTI	ti
ADJ_REIPAS	as
ADJ_RIETAS	as
ADJ_RIIVIÖ
ADJ_RUMA	a
ADJ_RÄVÄKKÄ	kä
ADJ_SANKA	ka
ADJ_SIPPI	pi
ADJ_SISIN	n
ADJ_STYDI	i
ADJ_SUIPPO	po
ADJ_SUOLISTETTAVA	a
ADJ_SUURI	i
ADJ_SYMPPIS	s
ADJ_SYYPÄÄ	ä
ADJ_SÄIKKY	ky
ADJ_SÄKKÄRÄ	ä
ADJ_TARKKA	ka
ADJ_TERVE
ADJ_TERÄVÄ	ä
ADJ_TIIVIS	is
ADJ_TOOPE
ADJ_TUHTI	ti
ADJ_TUMMAHKO
ADJ_TURTA	ta
ADJ_TYHMÄ	ä
ADJ_TYVEN
ADJ_TYYLIKÄS	äs
ADJ_TYÖLLISTETTÄVÄ	ä
ADJ_TYÖLÄS	s
ADJ_TÄYSI	si
ADJ_UUSI	si
ADJ_VALKAISTU
ADJ_VALMIS	is
ADJ_VAPAA	a
ADJ_VASEN	n
ADJ_VELTTO	to
ADJ_VENTO	to
ADJ_VIATON	on
ADJ_VIHANTA	ta
ADJ_VIIPALOITU	tu
ADJ_VIMMATTU	tu
ADJ_VIRKKU	ku
ADJ_VOIMAKAS	as
ADJ_VOIPA	pa
ADJ_VÄHÄTELTY	ty
ADJ_VÄNKÄ	kä
ADJ_VÄÄRTTI	ti
ADJ_YKSILÖITY	ty
ADJ_YLENNETTY	ty
ADJ_ÄLLISTYNYT	yt
ADJ_ÖYKKÄRI	i
ADP_ALLE
ADP_ALLA
ADP_HYVILLÄÄN	än
ADP_ILKOSILLAAN	an
ADP_ISTUALLEEN	en
ADP_KOTONA
ADP_LISÄKSI	i
ADP_LÄHELLÄ
ADP_MUKAAN	n
ADP_MUKAISESTI
ADP_NÄHDEN
ADP_NÄKYVIIN	n
ADP_TYKÖ
ADP_VALTAAN	n
ADP_VUOKSI	i
ADP_YLLE
ADV_AIKANSA
ADV_IKINÄ
ADV_JO
ADV_JONNE
ADV_KUHUN
ADV_LEVÄLLEEN
ADV_MITEN
ADV_NOPEASTI
ADV_TYHMÄSTI
ADV_VAAN
ADV_YLIPÄÄNSÄ
AUX_AIKOA	koa
AUX_JOUTUA	tua
AUX_MAHTAA	taa
AUX_OLLA	olla
AUX_PITÄÄ	tää
AUX_SAATTAA	taa
AUX_TAITAA	taa
AUX_TARVITA	ta
AUX_TÄYTYÄ	tyä
AUX_VOIDA	ida
CONJ_JA
DET_SE	e
DET_YKSI	ksi
INTJ_HAH
INTJ_OO
NOUN_51aavameri	ameri
NOUN_51hienosokeri	sokeri
NOUN_51isojako	jako
NOUN_51isokoskelo	koskelo
NOUN_51isokuovi	kuovi
NOUN_51isokäpylintu	käpylintu
NOUN_51isolepinkäinen	lepinkäinen
NOUN_51isolokki	lokki
NOUN_51isomaksaruoho	maksaruoho
NOUN_51isomasto	masto
NOUN_51isopanda	panda
NOUN_51isopistooli	pistooli
NOUN_51isopurje	purje
NOUN_51isorokko	rokko
NOUN_51isorumpu	rumpu
NOUN_51isosisar	sisar
NOUN_51isosisko	sisko
NOUN_51isotaivot	taivot
NOUN_51isovarvas	varvas
NOUN_51isoveli	veli
NOUN_51isoviha	viha
NOUN_51karkearehu	arehu
NOUN_51kevytsarja	tsarja
NOUN_51kirjavapillike	apillike
NOUN_51kuivakakku	akakku
NOUN_51kuivakukka	akukka
NOUN_51kuivamuona	amuona
NOUN_51kuivapaino	apaino
NOUN_51kuivapari	apari
NOUN_51kuivarehu	arehu
NOUN_51kultainennoutaja	nennoutaja
NOUN_51laiskakoira	akoira
NOUN_51lämminruoka	minruoka
NOUN_51lämminvarasto	minvarasto
NOUN_51lämminvaunu	minvaunu
NOUN_51matalameri	ameri
NOUN_51mustaherukka	aherukka
NOUN_51mustaleipä	aleipä
NOUN_51mustaleski	aleski
NOUN_51mustalintu	alintu
NOUN_51mustamaija	amaija
NOUN_51mustamakkara	amakkara
NOUN_51mustamies	amies
NOUN_51mustamulta	amulta
NOUN_51mustapekka	apekka
NOUN_51mustapippuri	apippuri
NOUN_51mustaraamattu	araamattu
NOUN_51mustatorvisieni	atorvisieni
NOUN_51mustaviinimarja	aviinimarja
NOUN_51nuoriemäntä	iemäntä
NOUN_51nuoriherra	iherra
NOUN_51nuori-isäntä	i-isäntä
NOUN_51nuorikarja	ikarja
NOUN_51nuorimies	imies
NOUN_51nuoripari	ipari
NOUN_51omakuva	akuva
NOUN_51omatunto	atunto
NOUN_51pahahenki	ahenki
NOUN_51pahaputki	aputki
NOUN_51palavakivi	akivi
NOUN_51palavapensas	apensas
NOUN_51palavarakkaus	arakkaus
NOUN_51pitkähousu	ähousu
NOUN_51pitkäkirkko	äkirkko
NOUN_51pitkäperjantai	äperjantai
NOUN_51pitkäpiimä	äpiimä
NOUN_51pitkäsiima	äsiima
NOUN_51pitkätakki	ätakki
NOUN_51pitkäthousut	äthousut
NOUN_51puolikuu	ikuu
NOUN_51puolimatka	imatka
NOUN_51puolipäivä	ipäivä
NOUN_51puoliväli	iväli
NOUN_51puoliyö	iyö
NOUN_51raitisilma	isilma
NOUN_51raskassarja	ssarja
NOUN_51raskasvesi	svesi
NOUN_51raskasvety	svety
NOUN_51sepiväpeippi	äpeippi
NOUN_51suorakulma	akulma
NOUN_51suoraommel	aommel
NOUN_51syvämeri	ämeri
NOUN_51särkynytsydän	ytsydän
NOUN_51tyhjäpaino	äpaino
NOUN_51täysikuu	sikuu
NOUN_51uusikuu	sikuu
NOUN_51Uusimaa	simaa
NOUN_51uusivuosi	sivuosi
NOUN_51vanhaemäntä	aemäntä
NOUN_51vanhaisäntä	aisäntä
NOUN_51vanhakaupunki	akaupunki
NOUN_51vanhapiika	apiika
NOUN_51vanhapoika	apoika
NOUN_51vierasmies	vierasmies
NOUN_AAKKOSELLISUUS	s
NOUN_AAKKOSTAMINEN	nen
NOUN_AALLOT	lot
NOUN_AAMUKAHDEKSAN	an
NOUN_AAMUKOLME	e
NOUN_AAMUKYMMENEN	en
NOUN_AAMUYHDEKSÄN	än
NOUN_AAMUYKSI	ksi
NOUN_AARRE	re
NOUN_ACRO_AA
NOUN_ACRO_CELSIUS
NOUN_ACRO_DOLLARI
NOUN_ACRO_EE
NOUN_ACRO_GRAMMA
NOUN_ACRO_GRAY
NOUN_ACRO_II
NOUN_ACRO_JOULE
NOUN_ACRO_JÄRJESTÖ
NOUN_ACRO_KAHDEKSAN
NOUN_ACRO_KAKSI
NOUN_ACRO_KANDELA
NOUN_ACRO_KOLMAS
NOUN_ACRO_KOLME
NOUN_ACRO_KUUSI
NOUN_ACRO_LEHTI
NOUN_ACRO_LUSIKKA
NOUN_ACRO_METRI
NOUN_ACRO_NELJÄ
NOUN_ACRO_NOLLA
NOUN_ACRO_OIKEUS
NOUN_ACRO_OK
NOUN_ACRO_OO
NOUN_ACRO_OPISTO
NOUN_ACRO_OPPILAS
NOUN_ACRO_PUNTA
NOUN_ACRO_SAIRAALA
NOUN_ACRO_SEITSEMÄN
NOUN_ACRO_TUOTE
NOUN_ACRO_UU
NOUN_ACRO_VIISI
NOUN_ACRO_VUOSI
NOUN_ACRO_WEBER
NOUN_ACRO_YHDEKSÄN
NOUN_ACRO_YHDISTYS
NOUN_ACRO_YKSI
NOUN_ACRO_YY
NOUN_ACRO_ZET
NOUN_ACRO_ÄKS
NOUN_ACRO_ÄÄ
NOUN_ACRO_ÖÖ
NOUN_ACRO_Ω
NOUN_AHDET	det
NOUN_AIKA	ika
NOUN_AIVOKUOLLUT	ut
NOUN_AIVOT	t
NOUN_AJATAR	ar
NOUN_ALKEET	keet
NOUN_ALKU	ku
NOUN_ALLAS	las
NOUN_ALTIS	is
NOUN_ANTIMET	timet
NOUN_APE	e
NOUN_APU	pu
NOUN_ARISTOTELES	s
NOUN_ARKI	ki
NOUN_ASEMA	a
NOUN_ASKAR
NOUN_ASKELLIN	lin
NOUN_ASTE
NOUN_ASU
NOUN_ASUKAS	as
NOUN_ATERIMET	met
NOUN_AUER	er
NOUN_BÉBÉ
NOUN_BEIGNET
NOUN_BERNIE
NOUN_BESSERWISSER
NOUN_BIDEE	e
NOUN_BIKINIT	t
NOUN_BORDEAUX
NOUN_BRASSERIE
NOUN_BRIE
NOUN_BÄNET	t
NOUN_CAMUS
NOUN_CHACHACHA
NOUN_COMPOUND	-
NOUN_COWBOY
NOUN_DIMITRIS	s
NOUN_EKKE	ke
NOUN_ELIN	n
NOUN_ELÄMÄ	ä
NOUN_EPÄILTY	ty
NOUN_ESIM.
NOUN_ESQUIMAU
NOUN_EUGENE
NOUN_EURO
NOUN_FARKUT	ut
NOUN_FARMARIT	it
NOUN_FIFA
NOUN_FONDUE
NOUN_FONDYY	y
NOUN_FÄNRIKIT	it
NOUN_GAY
NOUN_HAAKSI	ksi
NOUN_HAI	i
NOUN_HAIT	it
NOUN_HAMMAS	mas
NOUN_HAPAN	an
NOUN_HAPPI	pi
NOUN_HAPPO	po
NOUN_HAPSI	psi
NOUN_HARMAAT	at
NOUN_HEITIN	in
NOUN_HENKI	ki
NOUN_HEPO	po
NOUN_HIIRI	i
NOUN_HIPAT	at
NOUN_HIRTTO	to
NOUN_HIUTALEET	et
NOUN_HOKSOTTIMET	et
NOUN_HONKA	ka
NOUN_HOPEAT	at
NOUN_HORTA	ta
NOUN_HOUSUT	t
NOUN_HUOLITELTU	tu
NOUN_HUPI	pi
NOUN_HYLJE	je
NOUN_HYLKY	ky
NOUN_HYNTTEET	teet
NOUN_HYNTTYYT	tyyt
NOUN_HYÖTYY	y
NOUN_HÄIRIÖ
NOUN_HÄKKI	ki
NOUN_HÄKKYRÄ	ä
NOUN_HÄMET	t
NOUN_HÄMMINKI	ki
NOUN_HÄNNÄT	ät
NOUN_HÄNTÄ	tä
NOUN_HÄRKIN	n
NOUN_HÄVINNEET	et
NOUN_HÄÄT	ät
NOUN_HÄÄTÖ	tö
NOUN_HÖLKKÄ	kä
NOUN_HÖPÖTTÄJÄ	ä
NOUN_HÖYHENET	et
NOUN_IEN	en
NOUN_IES	es
NOUN_IKENET	kenet
NOUN_IMMYT	myt
NOUN_INGET	get
NOUN_ITÄMAAT	at
NOUN_JEPPE	pe
NOUN_JOCKEY
NOUN_JOUKOT	ot
NOUN_JOUTSEN
NOUN_JUHLAT	at
NOUN_JUMALA	a
NOUN_JUOVAT	vat
NOUN_JYLKYT	yt
NOUN_JÄLSI	si
NOUN_JÄRJESTÖT	t
NOUN_JÄRKI	ki
NOUN_JÄRVITAHDON	don
NOUN_JÄÄTELÖ
NOUN_KAARET	et
NOUN_KAARRET	ret
NOUN_KAARROT	rot
NOUN_KALATOIN	oin
NOUN_KAMPPEET	peet
NOUN_KANAALI	i
NOUN_KANGAS	gas
NOUN_KANGASALA	a
NOUN_KANKAHAT	hat
NOUN_KANNEL	nel
NOUN_KANNET	net
NOUN_KARRAT	rat
NOUN_KASTANJETIT	it
NOUN_KASTIKE	e
NOUN_KASTILJAT	at
NOUN_KAUSI	si
NOUN_KEHVELI	i
NOUN_KELTIS	is
NOUN_KENGÄT	gät
NOUN_KENKÄ	kä
NOUN_KENTTÄ	tä
NOUN_KENTÄT	ät
NOUN_KERITSIMET	met
NOUN_KERROIN	roin
NOUN_KERTA	ta
NOUN_KEVÄT	t
NOUN_KIDE	de
NOUN_KIELTO	to
NOUN_KIERRE	re
NOUN_KIERRIN	rin
NOUN_KIHARAT	t
NOUN_KIHARRIN	rin
NOUN_KIINNE	ne
NOUN_KIIRU
NOUN_KILPI	pi
NOUN_KILPIKKÄÄT	käät
NOUN_KINNAS	nas
NOUN_KINNER	ner
NOUN_KIRITTÄRET	täret
NOUN_KIRJA	a
NOUN_KIRVES	s
NOUN_KITARA	a
NOUN_KIVI	i
NOUN_KLUMPIT	it
NOUN_KOE	e
NOUN_KOKO	ko
NOUN_KOMPA	pa
NOUN_KORPI	pi
NOUN_KORTES	es
NOUN_KORTET	et
NOUN_KORTTI	ti
NOUN_KORVET	vet
NOUN_KOUVOT	t
NOUN_KREUS	s
NOUN_KUITU	tu
NOUN_KUMMUT	mut
NOUN_KUNGFU
NOUN_KUNNAT	nat
NOUN_KUNTA	ta
NOUN_KUOPAT	at
NOUN_KUOPPA	pa
NOUN_KUPPI	pi
NOUN_KUTSUNTA	ta
NOUN_KUULOKKEET	keet
NOUN_KUUS	s
NOUN_KYDÖT	döt
NOUN_KYKY	ky
NOUN_KYLKIÄINEN	nen
NOUN_KYLÄNVANHIN	n
NOUN_KYNNET	net
NOUN_KYNNÄÄT	ät
NOUN_KYSYNTÄ	tä
NOUN_KYYNEL
NOUN_KÄKI	ki
NOUN_KÄMMEKKÄ	kä
NOUN_KÄPY	py
NOUN_KÄPÄLÄ	ä
NOUN_KÄRJET	jet
NOUN_KÄRRY
NOUN_KÄRSÄKÄS	äs
NOUN_KÄRÄJÄT	ät
NOUN_KÄSITE	e
NOUN_KÄÄDYT	dyt
NOUN_KÄÄNNIN	nin
NOUN_KÄÄNTÖ	tö
NOUN_KÖNGÄS	gäs
NOUN_KÖYHYYS	s
NOUN_KÖYSI	si
NOUN_KÖÖ	ö
NOUN_LAET	et
NOUN_LAHDET	det
NOUN_LAHTI	ti
NOUN_LAIDUN	dun
NOUN_LAKI	ki
NOUN_LAMMET	met
NOUN_LAMMI	pi
NOUN_LAMMIT	mit
NOUN_LANKA	ka
NOUN_LANNET	net
NOUN_LAPSI	psi
NOUN_LASIT	t
NOUN_LEHDET	det
NOUN_LEHTI	ti
NOUN_LEIKKUU	u
NOUN_LEIPÄ	pä
NOUN_LENTTEE	e
NOUN_LEPAKKO	ko
NOUN_LIEMI	mi
NOUN_LIITTOUTUNEET	et
NOUN_LIIVIT	t
NOUN_LINGOT	got
NOUN_LINTU	tu
NOUN_LIPEÄ	ä
NOUN_LIPOTTARET	taret
NOUN_LIPPU	pu
NOUN_LIUKU	ku
NOUN_LIVVADIEVÁT	t
NOUN_LOKA	ka
NOUN_LOKKI	ki
NOUN_LOMMOL	mol
NOUN_LOTTE	te
NOUN_LOUET	et
NOUN_LUHDAT	dat
NOUN_LUKU	ku
NOUN_LUMME	me
NOUN_LUODE	de
NOUN_LUODES	des
NOUN_LUOKKA	ka
NOUN_LUOLIKOT	ot
NOUN_LUPA	pa
NOUN_LUSIKKA	ka
NOUN_LÄHDES	des
NOUN_LÄHDET	det
NOUN_LÄHIN	n
NOUN_LÄMMIN	min
NOUN_LÄMPÖ	pö
NOUN_LÄNGET	get
NOUN_LÄNSI	si
NOUN_LÄÄKE	e
NOUN_LÖPÖ	pö
NOUN_MAA	a
NOUN_MAKKARA	a
NOUN_MAKU	ku
NOUN_MALKO	ko
NOUN_MALTAAT	taat
NOUN_MANNER	ner
NOUN_MARKKINAT	at
NOUN_MATEE	e
NOUN_MATKUET	et
NOUN_MERI	i
NOUN_MERTU	tu
NOUN_METTE	te
NOUN_MIEHET	het
NOUN_MIELENGE	ge
NOUN_MIELLE	le
NOUN_MIES	s
NOUN_MILJÖÖ	ö
NOUN_MILJÖÖT	öt
NOUN_MITTA	ta
NOUN_MONSIEUR
NOUN_MULTA	ta
NOUN_MURTEET	teet
NOUN_MUUNNIN	nin
NOUN_MYRKKY	ky
NOUN_MÄET	et
NOUN_MÄNNYT	nyt
NOUN_MÄNTY	ty
NOUN_MÄTTÄÄT	täät
NOUN_MÄTÄS	äs
NOUN_MÖMMÖ
NOUN_MÖRKÖ	kö
NOUN_NALLE
NOUN_NEITSYT	t
#NOUN_NELJÄS
NOUN_NEUVOTTELUT	t
NOUN_NIEMET	t
NOUN_NIHTI	ti
NOUN_NIITUT	ut
NOUN_NIITYT	yt
NOUN_NIMETÖIN	töin
NOUN_NIMETÖN	tön
NOUN_NISSE
NOUN_NOKI	ki
NOUN_NOUGAT
NOUN_NUGAA	a
NOUN_NUKKE	ke
NOUN_NYLJIN	jin
NOUN_NÄKY	ky
NOUN_NÄKÖ	kö
NOUN_NÄLKÄ	kä
NOUN_OIKEUDET	det
NOUN_OLKA	ka
NOUN_OLUT	t
NOUN_OMMEL	mel
NOUN_ONKI	ki
NOUN_ONNET	et
NOUN_ONNI	i
NOUN_OOKOO	o
NOUN_OPINNOT	not
NOUN_ORI	i
NOUN_OSATON	ton
NOUN_OSOITE	e
NOUN_PAIKAT	at
NOUN_PANKIT	it
NOUN_PARFAIT
NOUN_PATA	ta
NOUN_PATEE	e
NOUN_PATSAS	s
NOUN_PEIPOT	ot
NOUN_PELKO	ko
NOUN_PELTI	ti
NOUN_PENGER	ger
NOUN_PERKEET	keet
NOUN_PIDOT	dot
NOUN_PIENNAR	nar
NOUN_PIHDIT	dit
NOUN_PII	i
NOUN_PIIROA	a
NOUN_PINSETIT	it
NOUN_PIPPALOT	t
NOUN_PISTE
NOUN_POHATTA	ta
NOUN_POHJE	je
NOUN_POIKA	ika
NOUN_POIUT	ut
NOUN_POJAT	jat
NOUN_POLITIIKKA	ka
NOUN_POLJIN	jin
NOUN_PONSI	si
NOUN_PORRAS	ras
NOUN_PORTAAT	taat
NOUN_PROBLEEMA	a
NOUN_PUHELIN	n
NOUN_PUIN	in
NOUN_PUKIMET	met
NOUN_PUNK
NOUN_PUU	u
NOUN_PUUT	ut
NOUN_PYHTÄÄ	ä
NOUN_PYKÄLÄ
NOUN_PYTTY	ty
NOUN_PYY	y
NOUN_PYYHE	e
NOUN_PYYHIN	in
NOUN_PYYT	yt
NOUN_PÄÄ	ä
NOUN_PÖKSYT	t
NOUN_PÖLHÄÄT	ät
NOUN_PÖLLÖT	t
NOUN_PÖNTTÖ	tö
NOUN_PÖYTÄ	tä
NOUN_RAAVIN	vin
NOUN_RAGUU	u
NOUN_RAKENNE	ne
NOUN_RAMPA	pa
NOUN_RANGAT	gat
NOUN_RANNAT	nat
NOUN_RAPPE	pe
NOUN_RAPPUSET	set
NOUN_RAPUT	ut
NOUN_RATAS	as
NOUN_RATTAAT	taat
NOUN_RAUDAT	dat
NOUN_RAUNIOT	t
NOUN_RAVET	t
NOUN_RAVUT	vut
NOUN_REGGAE
NOUN_REIKÄ	kä
NOUN_REIÄT	ät
NOUN_RENKAAT	kaat
NOUN_RIIPI	pi
NOUN_RIIVET	vet
NOUN_RIMMI	pi
NOUN_RIMMIT	mit
NOUN_RIMPI	pi
NOUN_RINNET	net
NOUN_RINTEET	teet
NOUN_RIPE	e
NOUN_RIPSET	et
NOUN_RIUTAT	at
NOUN_ROHTIMET	timet
NOUN_ROITOT	ot
NOUN_ROMPAAT	paat
NOUN_ROSÉ
NOUN_ROTAT	at
NOUN_ROTTA	ta
NOUN_RUIPELO
NOUN_RUIS	is
NOUN_RUMPU	pu
NOUN_RUNKO	ko
NOUN_RUOKA	oka
NOUN_RUOKO	ko
NOUN_RUOPPAAT	paat
NOUN_RUUHI	i
NOUN_RUUMIS	s
NOUN_RUUVI	i
NOUN_RYNNÄS	näs
NOUN_RYNTTYYT	tyyt
NOUN_RYNTÄÄT	täät
NOUN_RYPÄS	äs
NOUN_RYYPPY	py
NOUN_RÄJÄYTYS	s
NOUN_RÄMEET	et
NOUN_RÄMEÄT	ät
NOUN_RÄMIÄT	ät
NOUN_SAAPAS	as
NOUN_SAARET	et
NOUN_SAKSET	et
NOUN_SALONTEET	teet
NOUN_SALPA	pa
NOUN_SAMMALET	et
NOUN_SAMPI	pi
NOUN_SAMPO	po
NOUN_SANKARI	i
NOUN_SEIKKAILU
NOUN_SEIVÄS	väs
NOUN_SELENE
NOUN_SELJÄT	jät
NOUN_SENTTI
NOUN_SEPPÄ	pä
NOUN_SERGEJ
NOUN_SERKUKSET	kset
NOUN_SHOW
NOUN_SIEMEN
NOUN_SIIRTO	to
NOUN_SIIVILÄ	ä
NOUN_SILAKAT	at
NOUN_SILMÄKKEET	keet
NOUN_SISÄLTÖ	tö
NOUN_SIUNAAMATTOMAT	tomat
NOUN_SIVELLIN	lin
NOUN_SIVISTYNYT	yt
NOUN_SKEITTI	ti
NOUN_SOINTI	ti
NOUN_SOKEA	a
NOUN_SOTA	ta
NOUN_SPOTIFY
NOUN_STADION
NOUN_SUHTEET	teet
NOUN_SUKAT	at
NOUN_SULKA	ka
NOUN_SUODATIN	in
NOUN_SUOT	uot
NOUN_SYDÄN	n
NOUN_SYLI	i
NOUN_SYLTÄ	tä
NOUN_SYNNYTTIMET	timet
NOUN_SYÖMINGIT	git
NOUN_SÄEN	en
NOUN_SÄNKY	ky
NOUN_SÄRKÄT	ät
NOUN_SÄRVIN	vin
NOUN_SÄÄDIN	din
NOUN_SÄÄNNÖT	nöt
NOUN_SÄÄRET	et
NOUN_TAIMI	mi
NOUN_TAIVAL	val
NOUN_TALKOOT	ot
NOUN_TALO
NOUN_TANHUA	a
NOUN_TARPEET	peet
NOUN_TARVE	ve
NOUN_TAUDIT	dit
NOUN_TAUTI	ti
NOUN_TAVAT	vat
NOUN_TEE	e
NOUN_TEHDAS	das
NOUN_TEHTAAT	taat
NOUN_TEKO	ko
NOUN_TIE	ie
NOUN_TIENOO	o
NOUN_TIET	iet
NOUN_TIETEET	teet
NOUN_TIHVII	i
NOUN_TIKKAAT	kaat
NOUN_TIKKU	ku
NOUN_TIPPA	pa
NOUN_TOIMET	et
NOUN_TOKEE	e
NOUN_TONGIT	git
NOUN_TORTTU	tu
NOUN_TOULAT	at
NOUN_TRIKOO	o
NOUN_TUHKA	ka
NOUN_TULI	i
NOUN_TUNNIT	nit
NOUN_TUNTO	to
NOUN_TUOMIO
NOUN_TYPPI	pi
NOUN_TYTÄR	är
NOUN_TYTÖT	öt
NOUN_TYYLI	i
NOUN_TYYPPI	pi
NOUN_TYÖ	yö
NOUN_TYÖT	yöt
NOUN_TYÖTTÖMÄT	tömät
NOUN_TÖLPÄKÖT	öt
NOUN_TÖLPÄT	ät
NOUN_TÖRPPÖ	pö
NOUN_UDAR	dar
NOUN_UKKO	ko
NOUN_UKSI	ksi
NOUN_ULAPPA	pa
NOUN_UROS	s
NOUN_VAADIN	din
NOUN_VAAKA	ka
NOUN_VAANII	i
NOUN_VAATTEET	teet
NOUN_VAINAA	a
NOUN_VAKUUTUS	s
NOUN_VALJAAT	at
NOUN_VALLAT	lat
NOUN_VALTA	ta
NOUN_VANHEMMAT	mat
NOUN_VANHEMPI	pi
NOUN_VANKI	ki
NOUN_VANTUS	us
NOUN_VARAS	as
NOUN_VARAT	at
NOUN_VARPAAT	paat
NOUN_VARSI	si
NOUN_VARVAS	vas
NOUN_VASEN	n
NOUN_VEHKEILY
NOUN_VEITSI	tsi
NOUN_VELI	i
NOUN_VELJET	jet
NOUN_VEMMEL	mel
NOUN_VERI	i
NOUN_VERSAILLES
NOUN_VETIMET	timet
NOUN_VETO	to
NOUN_VETY	ty
NOUN_VIENTI	ti
NOUN_VIHKIÄISET	set
NOUN_VIHKO	ko
NOUN_VIIRRET	ret
NOUN_VIIS	s
NOUN_VIIVE	ve
NOUN_VIKA	ka
NOUN_VINKU	ku
NOUN_VIRRET	ret
NOUN_VIRSI	si
NOUN_VOIMA	a
NOUN_VUO	uo
NOUN_VUODET	det
NOUN_VUOLLE	le
NOUN_VUOLLET	let
NOUN_VUOSITUHAT	t
NOUN_VÄRTÖ	tö
NOUN_YHTIÖT	t
NOUN_YKSIKKÖ	kö
NOUN_YLKÄ	kä
NOUN_YLÄNKÖ	kö
NOUN_YLÖÖ	ö
NOUN_YMPÄRYSTÄ	ä
NOUN_YRITTÄ	tä
NOUN_YSTÄVYKSET	kset
NOUN_YÖKKÖ	kö
NOUN_ZEN
NOUN_ZOMBIE
NOUN_ÄYRÄS	s
NUM_51kahdeksanbiljardia	anbiljardia
NUM_51kahdeksanbiljoonaa	anbiljoonaa
NUM_51kahdeksandekiljardia	andekiljardia
NUM_51kahdeksandekiljoonaa	andekiljoonaa
NUM_51kahdeksanduodekiljardia	anduodekiljardia
NUM_51kahdeksanduodekiljoonaa	anduodekiljoonaa
NUM_51kahdeksankahdeksatta	ankahdeksatta
NUM_51kahdeksankiljardia	ankiljardia
NUM_51kahdeksankiljoonaa	ankiljoonaa
NUM_51kahdeksankolmatta	ankolmatta
NUM_51kahdeksankuudetta	ankuudetta
NUM_51kahdeksankvadriljardia	ankvadriljardia
NUM_51kahdeksankvadriljoonaa	ankvadriljoonaa
NUM_51kahdeksankvintiljardia	ankvintiljardia
NUM_51kahdeksankvintiljoonaa	ankvintiljoonaa
NUM_51kahdeksankymmentä	ankymmentä
NUM_51kahdeksanmiljardia	anmiljardia
NUM_51kahdeksanmiljoonaa	anmiljoonaa
NUM_51kahdeksanneljättä	anneljättä
NUM_51kahdeksannoniljardia	annoniljardia
NUM_51kahdeksannoniljoonaa	annoniljoonaa
NUM_51kahdeksanoktiljardia	anoktiljardia
NUM_51kahdeksanoktiljoonaa	anoktiljoonaa
NUM_51kahdeksanpiljardia	anpiljardia
NUM_51kahdeksanpiljoonaa	anpiljoonaa
NUM_51kahdeksansataa	ansataa
NUM_51kahdeksanseitsemättä	anseitsemättä
NUM_51kahdeksansentiljardia	ansentiljardia
NUM_51kahdeksansentiljoonaa	ansentiljoonaa
NUM_51kahdeksanseptiljardia	anseptiljardia
NUM_51kahdeksanseptiljoonaa	anseptiljoonaa
NUM_51kahdeksantoista	antoista
NUM_51kahdeksantredekiljardia	antredekiljardia
NUM_51kahdeksantredekiljoonaa	antredekiljoonaa
NUM_51kahdeksantriljardia	antriljardia
NUM_51kahdeksantriljoonaa	antriljoonaa
NUM_51kahdeksantsiljardia	antsiljardia
NUM_51kahdeksantsiljoonaa	antsiljoonaa
NUM_51kahdeksantuhatta	antuhatta
NUM_51kahdeksanundekiljardia	anundekiljardia
NUM_51kahdeksanundekiljoonaa	anundekiljoonaa
NUM_51kahdeksanviidettä	anviidettä
NUM_51kahdeksanyhdeksättä	anyhdeksättä
NUM_51kahdeksasbiljardis	asbiljardis
NUM_51kahdeksasbiljoonas	asbiljoonas
NUM_51kahdeksasdekiljardis	asdekiljardis
NUM_51kahdeksasdekiljoonas	asdekiljoonas
NUM_51kahdeksasduodekiljardis	asduodekiljardis
NUM_51kahdeksasduodekiljoonas	asduodekiljoonas
NUM_51kahdeksaskahdeksatta	askahdeksatta
NUM_51kahdeksaskiljardis	askiljardis
NUM_51kahdeksaskiljoonas	askiljoonas
NUM_51kahdeksaskolmatta	askolmatta
NUM_51kahdeksaskuudetta	askuudetta
NUM_51kahdeksaskvadriljardis	askvadriljardis
NUM_51kahdeksaskvadriljoonas	askvadriljoonas
NUM_51kahdeksaskvintiljardis	askvintiljardis
NUM_51kahdeksaskvintiljoonas	askvintiljoonas
NUM_51kahdeksaskymmenes	askymmenes
NUM_51kahdeksasmiljardis	asmiljardis
NUM_51kahdeksasmiljoonas	asmiljoonas
NUM_51kahdeksasneljästtä	asneljästtä
NUM_51kahdeksasnoniljardis	asnoniljardis
NUM_51kahdeksasnoniljoonas	asnoniljoonas
NUM_51kahdeksasoktiljardis	asoktiljardis
NUM_51kahdeksasoktiljoonas	asoktiljoonas
NUM_51kahdeksaspiljardis	aspiljardis
NUM_51kahdeksaspiljoonas	aspiljoonas
NUM_51kahdeksassadas	assadas
NUM_51kahdeksasseitsemättä	asseitsemättä
NUM_51kahdeksassentiljardis	assentiljardis
NUM_51kahdeksassentiljoonas	assentiljoonas
NUM_51kahdeksasseptiljardis	asseptiljardis
NUM_51kahdeksasseptiljoonas	asseptiljoonas
NUM_51kahdeksastoista	astoista
NUM_51kahdeksastredekiljardis	astredekiljardis
NUM_51kahdeksastredekiljoonas	astredekiljoonas
NUM_51kahdeksastriljardis	astriljardis
NUM_51kahdeksastriljoonas	astriljoonas
NUM_51kahdeksastsiljardis	astsiljardis
NUM_51kahdeksastsiljoonas	astsiljoonas
NUM_51kahdeksastuhannes	astuhannes
NUM_51kahdeksasundekiljardis	asundekiljardis
NUM_51kahdeksasundekiljoonas	asundekiljoonas
NUM_51kahdeksasviidettä	asviidettä
NUM_51kahdeksasyhdeksättä	asyhdeksättä
NUM_51kahdesbiljardis	sbiljardis
NUM_51kahdesbiljoonas	sbiljoonas
NUM_51kahdesdekiljardis	sdekiljardis
NUM_51kahdesdekiljoonas	sdekiljoonas
NUM_51kahdesduodekiljardis	sduodekiljardis
NUM_51kahdesduodekiljoonas	sduodekiljoonas
NUM_51kahdeskahdeksatta	skahdeksatta
NUM_51kahdeskiljardis	skiljardis
NUM_51kahdeskiljoonas	skiljoonas
NUM_51kahdeskolmatta	skolmatta
NUM_51kahdeskuudetta	skuudetta
NUM_51kahdeskvadriljardis	skvadriljardis
NUM_51kahdeskvadriljoonas	skvadriljoonas
NUM_51kahdeskvintiljardis	skvintiljardis
NUM_51kahdeskvintiljoonas	skvintiljoonas
NUM_51kahdeskymmenes	skymmenes
NUM_51kahdesmiljardis	smiljardis
NUM_51kahdesmiljoonas	smiljoonas
NUM_51kahdesneljästtä	sneljästtä
NUM_51kahdesnoniljardis	snoniljardis
NUM_51kahdesnoniljoonas	snoniljoonas
NUM_51kahdesoktiljardis	soktiljardis
NUM_51kahdesoktiljoonas	soktiljoonas
NUM_51kahdespiljardis	spiljardis
NUM_51kahdespiljoonas	spiljoonas
NUM_51kahdessadas	ssadas
NUM_51kahdesseitsemättä	sseitsemättä
NUM_51kahdessentiljardis	ssentiljardis
NUM_51kahdessentiljoonas	ssentiljoonas
NUM_51kahdesseptiljardis	sseptiljardis
NUM_51kahdesseptiljoonas	sseptiljoonas
NUM_51kahdestoista	stoista
NUM_51kahdestredekiljardis	stredekiljardis
NUM_51kahdestredekiljoonas	stredekiljoonas
NUM_51kahdestriljardis	striljardis
NUM_51kahdestriljoonas	striljoonas
NUM_51kahdestsiljardis	stsiljardis
NUM_51kahdestsiljoonas	stsiljoonas
NUM_51kahdestuhannes	stuhannes
NUM_51kahdesundekiljardis	sundekiljardis
NUM_51kahdesundekiljoonas	sundekiljoonas
NUM_51kahdesviidettä	sviidettä
NUM_51kahdesyhdeksättä	syhdeksättä
NUM_51kaksibiljardia	ksibiljardia
NUM_51kaksibiljoonaa	ksibiljoonaa
NUM_51kaksidekiljardia	ksidekiljardia
NUM_51kaksidekiljoonaa	ksidekiljoonaa
NUM_51kaksiduodekiljardia	ksiduodekiljardia
NUM_51kaksiduodekiljoonaa	ksiduodekiljoonaa
NUM_51kaksikahdeksatta	ksikahdeksatta
NUM_51kaksikiljardia	ksikiljardia
NUM_51kaksikiljoonaa	ksikiljoonaa
NUM_51kaksikolmatta	ksikolmatta
NUM_51kaksikuudetta	ksikuudetta
NUM_51kaksikvadriljardia	ksikvadriljardia
NUM_51kaksikvadriljoonaa	ksikvadriljoonaa
NUM_51kaksikvintiljardia	ksikvintiljardia
NUM_51kaksikvintiljoonaa	ksikvintiljoonaa
NUM_51kaksikymmentä	ksikymmentä
NUM_51kaksimiljardia	ksimiljardia
NUM_51kaksimiljoonaa	ksimiljoonaa
NUM_51kaksineljättä	ksineljättä
NUM_51kaksinoniljardia	ksinoniljardia
NUM_51kaksinoniljoonaa	ksinoniljoonaa
NUM_51kaksioktiljardia	ksioktiljardia
NUM_51kaksioktiljoonaa	ksioktiljoonaa
NUM_51kaksipiljardia	ksipiljardia
NUM_51kaksipiljoonaa	ksipiljoonaa
NUM_51kaksisataa	ksisataa
NUM_51kaksiseitsemättä	ksiseitsemättä
NUM_51kaksisentiljardia	ksisentiljardia
NUM_51kaksisentiljoonaa	ksisentiljoonaa
NUM_51kaksiseptiljardia	ksiseptiljardia
NUM_51kaksiseptiljoonaa	ksiseptiljoonaa
NUM_51kaksitoista	ksitoista
NUM_51kaksitredekiljardia	ksitredekiljardia
NUM_51kaksitredekiljoonaa	ksitredekiljoonaa
NUM_51kaksitriljardia	ksitriljardia
NUM_51kaksitriljoonaa	ksitriljoonaa
NUM_51kaksitsiljardia	ksitsiljardia
NUM_51kaksitsiljoonaa	ksitsiljoonaa
NUM_51kaksituhatta	ksituhatta
NUM_51kaksiundekiljardia	ksiundekiljardia
NUM_51kaksiundekiljoonaa	ksiundekiljoonaa
NUM_51kaksiviidettä	ksiviidettä
NUM_51kaksiyhdeksättä	ksiyhdeksättä
NUM_51kolmasbiljardis	sbiljardis
NUM_51kolmasbiljoonas	sbiljoonas
NUM_51kolmasdekiljardis	sdekiljardis
NUM_51kolmasdekiljoonas	sdekiljoonas
NUM_51kolmasduodekiljardis	sduodekiljardis
NUM_51kolmasduodekiljoonas	sduodekiljoonas
NUM_51kolmaskahdeksatta	skahdeksatta
NUM_51kolmaskiljardis	skiljardis
NUM_51kolmaskiljoonas	skiljoonas
NUM_51kolmaskolmatta	skolmatta
NUM_51kolmaskuudetta	skuudetta
NUM_51kolmaskvadriljardis	skvadriljardis
NUM_51kolmaskvadriljoonas	skvadriljoonas
NUM_51kolmaskvintiljardis	skvintiljardis
NUM_51kolmaskvintiljoonas	skvintiljoonas
NUM_51kolmaskymmenes	skymmenes
NUM_51kolmasmiljardis	smiljardis
NUM_51kolmasmiljoonas	smiljoonas
NUM_51kolmasneljättä	sneljättä
NUM_51kolmasnoniljardis	snoniljardis
NUM_51kolmasnoniljoonas	snoniljoonas
NUM_51kolmasoktiljardis	soktiljardis
NUM_51kolmasoktiljoonas	soktiljoonas
NUM_51kolmaspiljardis	spiljardis
NUM_51kolmaspiljoonas	spiljoonas
NUM_51kolmassadas	ssadas
NUM_51kolmasseitsemättä	sseitsemättä
NUM_51kolmassentiljardis	ssentiljardis
NUM_51kolmassentiljoonas	ssentiljoonas
NUM_51kolmasseptiljardis	sseptiljardis
NUM_51kolmasseptiljoonas	sseptiljoonas
NUM_51kolmastoista	stoista
NUM_51kolmastredekiljardis	stredekiljardis
NUM_51kolmastredekiljoonas	stredekiljoonas
NUM_51kolmastriljardis	striljardis
NUM_51kolmastriljoonas	striljoonas
NUM_51kolmastsiljardis	stsiljardis
NUM_51kolmastsiljoonas	stsiljoonas
NUM_51kolmastuhannes	stuhannes
NUM_51kolmasundekiljardis	sundekiljardis
NUM_51kolmasundekiljoonas	sundekiljoonas
NUM_51kolmasviidettä	sviidettä
NUM_51kolmasyhdeksättä	syhdeksättä
NUM_51kolmebiljardia	ebiljardia
NUM_51kolmebiljoonaa	ebiljoonaa
NUM_51kolmedekiljardia	edekiljardia
NUM_51kolmedekiljoonaa	edekiljoonaa
NUM_51kolmeduodekiljardia	eduodekiljardia
NUM_51kolmeduodekiljoonaa	eduodekiljoonaa
NUM_51kolmekahdeksatta	ekahdeksatta
NUM_51kolmekiljardia	ekiljardia
NUM_51kolmekiljoonaa	ekiljoonaa
NUM_51kolmekolmatta	ekolmatta
NUM_51kolmekuudetta	ekuudetta
NUM_51kolmekvadriljardia	ekvadriljardia
NUM_51kolmekvadriljoonaa	ekvadriljoonaa
NUM_51kolmekvintiljardia	ekvintiljardia
NUM_51kolmekvintiljoonaa	ekvintiljoonaa
NUM_51kolmekymmentä	ekymmentä
NUM_51kolmemiljardia	emiljardia
NUM_51kolmemiljoonaa	emiljoonaa
NUM_51kolmeneljättä	eneljättä
NUM_51kolmenoniljardia	enoniljardia
NUM_51kolmenoniljoonaa	enoniljoonaa
NUM_51kolmeoktiljardia	eoktiljardia
NUM_51kolmeoktiljoonaa	eoktiljoonaa
NUM_51kolmepiljardia	epiljardia
NUM_51kolmepiljoonaa	epiljoonaa
NUM_51kolmesataa	esataa
NUM_51kolmeseitsemättä	eseitsemättä
NUM_51kolmesentiljardia	esentiljardia
NUM_51kolmesentiljoonaa	esentiljoonaa
NUM_51kolmeseptiljardia	eseptiljardia
NUM_51kolmeseptiljoonaa	eseptiljoonaa
NUM_51kolmetoista	etoista
NUM_51kolmetredekiljardia	etredekiljardia
NUM_51kolmetredekiljoonaa	etredekiljoonaa
NUM_51kolmetriljardia	etriljardia
NUM_51kolmetriljoonaa	etriljoonaa
NUM_51kolmetsiljardia	etsiljardia
NUM_51kolmetsiljoonaa	etsiljoonaa
NUM_51kolmetuhatta	etuhatta
NUM_51kolmeundekiljardia	eundekiljardia
NUM_51kolmeundekiljoonaa	eundekiljoonaa
NUM_51kolmeviidettä	eviidettä
NUM_51kolmeyhdeksättä	eyhdeksättä
NUM_51kuudesbiljardis	sbiljardis
NUM_51kuudesbiljoonas	sbiljoonas
NUM_51kuudesdekiljardis	sdekiljardis
NUM_51kuudesdekiljoonas	sdekiljoonas
NUM_51kuudesduodekiljardis	sduodekiljardis
NUM_51kuudesduodekiljoonas	sduodekiljoonas
NUM_51kuudeskahdeksatta	skahdeksatta
NUM_51kuudeskiljardis	skiljardis
NUM_51kuudeskiljoonas	skiljoonas
NUM_51kuudeskolmatta	skolmatta
NUM_51kuudeskuudetta	skuudetta
NUM_51kuudeskvadriljardis	skvadriljardis
NUM_51kuudeskvadriljoonas	skvadriljoonas
NUM_51kuudeskvintiljardis	skvintiljardis
NUM_51kuudeskvintiljoonas	skvintiljoonas
NUM_51kuudeskymmenes	skymmenes
NUM_51kuudesmiljardis	smiljardis
NUM_51kuudesmiljoonas	smiljoonas
NUM_51kuudesneljästtä	sneljästtä
NUM_51kuudesnoniljardis	snoniljardis
NUM_51kuudesnoniljoonas	snoniljoonas
NUM_51kuudesoktiljardis	soktiljardis
NUM_51kuudesoktiljoonas	soktiljoonas
NUM_51kuudespiljardis	spiljardis
NUM_51kuudespiljoonas	spiljoonas
NUM_51kuudessadas	ssadas
NUM_51kuudesseitsemättä	sseitsemättä
NUM_51kuudessentiljardis	ssentiljardis
NUM_51kuudessentiljoonas	ssentiljoonas
NUM_51kuudesseptiljardis	sseptiljardis
NUM_51kuudesseptiljoonas	sseptiljoonas
NUM_51kuudestoista	stoista
NUM_51kuudestredekiljardis	stredekiljardis
NUM_51kuudestredekiljoonas	stredekiljoonas
NUM_51kuudestriljardis	striljardis
NUM_51kuudestriljoonas	striljoonas
NUM_51kuudestsiljardis	stsiljardis
NUM_51kuudestsiljoonas	stsiljoonas
NUM_51kuudestuhannes	stuhannes
NUM_51kuudesundekiljardis	sundekiljardis
NUM_51kuudesundekiljoonas	sundekiljoonas
NUM_51kuudesviidettä	sviidettä
NUM_51kuudesyhdeksättä	syhdeksättä
NUM_51kuusibiljardia	sibiljardia
NUM_51kuusibiljoonaa	sibiljoonaa
NUM_51kuusidekiljardia	sidekiljardia
NUM_51kuusidekiljoonaa	sidekiljoonaa
NUM_51kuusiduodekiljardia	siduodekiljardia
NUM_51kuusiduodekiljoonaa	siduodekiljoonaa
NUM_51kuusikahdeksatta	sikahdeksatta
NUM_51kuusikiljardia	sikiljardia
NUM_51kuusikiljoonaa	sikiljoonaa
NUM_51kuusikolmatta	sikolmatta
NUM_51kuusikuudetta	sikuudetta
NUM_51kuusikvadriljardia	sikvadriljardia
NUM_51kuusikvadriljoonaa	sikvadriljoonaa
NUM_51kuusikvintiljardia	sikvintiljardia
NUM_51kuusikvintiljoonaa	sikvintiljoonaa
NUM_51kuusikymmentä	sikymmentä
NUM_51kuusimiljardia	similjardia
NUM_51kuusimiljoonaa	similjoonaa
NUM_51kuusineljättä	sineljättä
NUM_51kuusinoniljardia	sinoniljardia
NUM_51kuusinoniljoonaa	sinoniljoonaa
NUM_51kuusioktiljardia	sioktiljardia
NUM_51kuusioktiljoonaa	sioktiljoonaa
NUM_51kuusipiljardia	sipiljardia
NUM_51kuusipiljoonaa	sipiljoonaa
NUM_51kuusisataa	sisataa
NUM_51kuusiseitsemättä	siseitsemättä
NUM_51kuusisentiljardia	sisentiljardia
NUM_51kuusisentiljoonaa	sisentiljoonaa
NUM_51kuusiseptiljardia	siseptiljardia
NUM_51kuusiseptiljoonaa	siseptiljoonaa
NUM_51kuusitoista	sitoista
NUM_51kuusitredekiljardia	sitredekiljardia
NUM_51kuusitredekiljoonaa	sitredekiljoonaa
NUM_51kuusitriljardia	sitriljardia
NUM_51kuusitriljoonaa	sitriljoonaa
NUM_51kuusitsiljardia	sitsiljardia
NUM_51kuusitsiljoonaa	sitsiljoonaa
NUM_51kuusituhatta	situhatta
NUM_51kuusiundekiljardia	siundekiljardia
NUM_51kuusiundekiljoonaa	siundekiljoonaa
NUM_51kuusiviidettä	siviidettä
NUM_51kuusiyhdeksättä	siyhdeksättä
NUM_51neljäbiljardia	äbiljardia
NUM_51neljäbiljoonaa	äbiljoonaa
NUM_51neljädekiljardia	ädekiljardia
NUM_51neljädekiljoonaa	ädekiljoonaa
NUM_51neljäduodekiljardia	äduodekiljardia
NUM_51neljäduodekiljoonaa	äduodekiljoonaa
NUM_51neljäkahdeksatta	äkahdeksatta
NUM_51neljäkiljardia	äkiljardia
NUM_51neljäkiljoonaa	äkiljoonaa
NUM_51neljäkolmatta	äkolmatta
NUM_51neljäkuudetta	äkuudetta
NUM_51neljäkvadriljardia	äkvadriljardia
NUM_51neljäkvadriljoonaa	äkvadriljoonaa
NUM_51neljäkvintiljardia	äkvintiljardia
NUM_51neljäkvintiljoonaa	äkvintiljoonaa
NUM_51neljäkymmentä	äkymmentä
NUM_51neljämiljardia	ämiljardia
NUM_51neljämiljoonaa	ämiljoonaa
NUM_51neljäneljättä	äneljättä
NUM_51neljänoniljardia	änoniljardia
NUM_51neljänoniljoonaa	änoniljoonaa
NUM_51neljäoktiljardia	äoktiljardia
NUM_51neljäoktiljoonaa	äoktiljoonaa
NUM_51neljäpiljardia	äpiljardia
NUM_51neljäpiljoonaa	äpiljoonaa
NUM_51neljäsataa	äsataa
NUM_51neljäsbiljardis	sbiljardis
NUM_51neljäsbiljoonas	sbiljoonas
NUM_51neljäsdekiljardis	sdekiljardis
NUM_51neljäsdekiljoonas	sdekiljoonas
NUM_51neljäsduodekiljardis	sduodekiljardis
NUM_51neljäsduodekiljoonas	sduodekiljoonas
NUM_51neljäseitsemättä	seitsemättä
NUM_51neljäsentiljardia	sentiljardia
NUM_51neljäsentiljoonaa	sentiljoonaa
NUM_51neljäseptiljardia	septiljardia
NUM_51neljäseptiljoonaa	septiljoonaa
NUM_51neljäskahdeksatta	skahdeksatta
NUM_51neljäskiljardis	skiljardis
NUM_51neljäskiljoonas	skiljoonas
NUM_51neljäskolmatta	skolmatta
NUM_51neljäskuudetta	skuudetta
NUM_51neljäskvadriljardis	skvadriljardis
NUM_51neljäskvadriljoonas	skvadriljoonas
NUM_51neljäskvintiljardis	skvintiljardis
NUM_51neljäskvintiljoonas	skvintiljoonas
NUM_51neljäskymmenes	skymmenes
NUM_51neljäsmiljardis	smiljardis
NUM_51neljäsmiljoonas	smiljoonas
NUM_51neljäsneljättä	sneljättä
NUM_51neljäsnoniljardis	snoniljardis
NUM_51neljäsnoniljoonas	snoniljoonas
NUM_51neljäsoktiljardis	soktiljardis
NUM_51neljäsoktiljoonas	soktiljoonas
NUM_51neljäspiljardis	spiljardis
NUM_51neljäspiljoonas	spiljoonas
NUM_51neljässadas	ssadas
NUM_51neljässeitsemättä	sseitsemättä
NUM_51neljässentiljardis	ssentiljardis
NUM_51neljässentiljoonas	ssentiljoonas
NUM_51neljässeptiljardis	sseptiljardis
NUM_51neljässeptiljoonas	sseptiljoonas
NUM_51neljästoista	stoista
NUM_51neljästredekiljardis	stredekiljardis
NUM_51neljästredekiljoonas	stredekiljoonas
NUM_51neljästriljardis	striljardis
NUM_51neljästriljoonas	striljoonas
NUM_51neljästsiljardis	stsiljardis
NUM_51neljästsiljoonas	stsiljoonas
NUM_51neljästuhannes	stuhannes
NUM_51neljäsundekiljardis	sundekiljardis
NUM_51neljäsundekiljoonas	sundekiljoonas
NUM_51neljäsviidettä	sviidettä
NUM_51neljäsyhdeksättä	syhdeksättä
NUM_51neljätoista	ätoista
NUM_51neljätredekiljardia	ätredekiljardia
NUM_51neljätredekiljoonaa	ätredekiljoonaa
NUM_51neljätriljardia	ätriljardia
NUM_51neljätriljoonaa	ätriljoonaa
NUM_51neljätsiljardia	ätsiljardia
NUM_51neljätsiljoonaa	ätsiljoonaa
NUM_51neljätuhatta	ätuhatta
NUM_51neljäundekiljardia	äundekiljardia
NUM_51neljäundekiljoonaa	äundekiljoonaa
NUM_51neljäviidettä	äviidettä
NUM_51neljäyhdeksättä	äyhdeksättä
NUM_51puolitoista	puolitoista
NUM_51seitsemänbiljardia	änbiljardia
NUM_51seitsemänbiljoonaa	änbiljoonaa
NUM_51seitsemändekiljardia	ändekiljardia
NUM_51seitsemändekiljoonaa	ändekiljoonaa
NUM_51seitsemänduodekiljardia	änduodekiljardia
NUM_51seitsemänduodekiljoonaa	änduodekiljoonaa
NUM_51seitsemänkahdeksatta	änkahdeksatta
NUM_51seitsemänkiljardia	änkiljardia
NUM_51seitsemänkiljoonaa	änkiljoonaa
NUM_51seitsemänkolmatta	änkolmatta
NUM_51seitsemänkuudetta	änkuudetta
NUM_51seitsemänkvadriljardia	änkvadriljardia
NUM_51seitsemänkvadriljoonaa	änkvadriljoonaa
NUM_51seitsemänkvintiljardia	änkvintiljardia
NUM_51seitsemänkvintiljoonaa	änkvintiljoonaa
NUM_51seitsemänkymmentä	änkymmentä
NUM_51seitsemänmiljardia	änmiljardia
NUM_51seitsemänmiljoonaa	änmiljoonaa
NUM_51seitsemänneljättä	änneljättä
NUM_51seitsemännoniljardia	ännoniljardia
NUM_51seitsemännoniljoonaa	ännoniljoonaa
NUM_51seitsemänoktiljardia	änoktiljardia
NUM_51seitsemänoktiljoonaa	änoktiljoonaa
NUM_51seitsemänpiljardia	änpiljardia
NUM_51seitsemänpiljoonaa	änpiljoonaa
NUM_51seitsemänsataa	änsataa
NUM_51seitsemänseitsemättä	änseitsemättä
NUM_51seitsemänsentiljardia	änsentiljardia
NUM_51seitsemänsentiljoonaa	änsentiljoonaa
NUM_51seitsemänseptiljardia	änseptiljardia
NUM_51seitsemänseptiljoonaa	änseptiljoonaa
NUM_51seitsemäntoista	äntoista
NUM_51seitsemäntredekiljardia	äntredekiljardia
NUM_51seitsemäntredekiljoonaa	äntredekiljoonaa
NUM_51seitsemäntriljardia	äntriljardia
NUM_51seitsemäntriljoonaa	äntriljoonaa
NUM_51seitsemäntsiljardia	äntsiljardia
NUM_51seitsemäntsiljoonaa	äntsiljoonaa
NUM_51seitsemäntuhatta	äntuhatta
NUM_51seitsemänundekiljardia	änundekiljardia
NUM_51seitsemänundekiljoonaa	änundekiljoonaa
NUM_51seitsemänviidettä	änviidettä
NUM_51seitsemänyhdeksättä	änyhdeksättä
NUM_51seitsemäsbiljardis	sbiljardis
NUM_51seitsemäsbiljoonas	sbiljoonas
NUM_51seitsemäsdekiljardis	sdekiljardis
NUM_51seitsemäsdekiljoonas	sdekiljoonas
NUM_51seitsemäsduodekiljardis	sduodekiljardis
NUM_51seitsemäsduodekiljoonas	sduodekiljoonas
NUM_51seitsemäskahdeksatta	skahdeksatta
NUM_51seitsemäskiljardis	skiljardis
NUM_51seitsemäskiljoonas	skiljoonas
NUM_51seitsemäskolmatta	skolmatta
NUM_51seitsemäskuudetta	skuudetta
NUM_51seitsemäskvadriljardis	skvadriljardis
NUM_51seitsemäskvadriljoonas	skvadriljoonas
NUM_51seitsemäskvintiljardis	skvintiljardis
NUM_51seitsemäskvintiljoonas	skvintiljoonas
NUM_51seitsemäskymmenes	skymmenes
NUM_51seitsemäsmiljardis	smiljardis
NUM_51seitsemäsmiljoonas	smiljoonas
NUM_51seitsemäsneljästtä	sneljästtä
NUM_51seitsemäsnoniljardis	snoniljardis
NUM_51seitsemäsnoniljoonas	snoniljoonas
NUM_51seitsemäsoktiljardis	soktiljardis
NUM_51seitsemäsoktiljoonas	soktiljoonas
NUM_51seitsemäspiljardis	spiljardis
NUM_51seitsemäspiljoonas	spiljoonas
NUM_51seitsemässadas	ssadas
NUM_51seitsemässeitsemättä	sseitsemättä
NUM_51seitsemässentiljardis	ssentiljardis
NUM_51seitsemässentiljoonas	ssentiljoonas
NUM_51seitsemässeptiljardis	sseptiljardis
NUM_51seitsemässeptiljoonas	sseptiljoonas
NUM_51seitsemästoista	stoista
NUM_51seitsemästredekiljardis	stredekiljardis
NUM_51seitsemästredekiljoonas	stredekiljoonas
NUM_51seitsemästriljardis	striljardis
NUM_51seitsemästriljoonas	striljoonas
NUM_51seitsemästsiljardis	stsiljardis
NUM_51seitsemästsiljoonas	stsiljoonas
NUM_51seitsemästuhannes	stuhannes
NUM_51seitsemäsundekiljardis	sundekiljardis
NUM_51seitsemäsundekiljoonas	sundekiljoonas
NUM_51seitsemäsviidettä	sviidettä
NUM_51seitsemäsyhdeksättä	syhdeksättä
NUM_51viidesbiljardis	sbiljardis
NUM_51viidesbiljoonas	sbiljoonas
NUM_51viidesdekiljardis	sdekiljardis
NUM_51viidesdekiljoonas	sdekiljoonas
NUM_51viidesduodekiljardis	sduodekiljardis
NUM_51viidesduodekiljoonas	sduodekiljoonas
NUM_51viideskahdeksatta	skahdeksatta
NUM_51viideskiljardis	skiljardis
NUM_51viideskiljoonas	skiljoonas
NUM_51viideskolmatta	skolmatta
NUM_51viideskuudetta	skuudetta
NUM_51viideskvadriljardis	skvadriljardis
NUM_51viideskvadriljoonas	skvadriljoonas
NUM_51viideskvintiljardis	skvintiljardis
NUM_51viideskvintiljoonas	skvintiljoonas
NUM_51viideskymmenes	skymmenes
NUM_51viidesmiljardis	smiljardis
NUM_51viidesmiljoonas	smiljoonas
NUM_51viidesneljästtä	sneljästtä
NUM_51viidesnoniljardis	snoniljardis
NUM_51viidesnoniljoonas	snoniljoonas
NUM_51viidesoktiljardis	soktiljardis
NUM_51viidesoktiljoonas	soktiljoonas
NUM_51viidespiljardis	spiljardis
NUM_51viidespiljoonas	spiljoonas
NUM_51viidessadas	ssadas
NUM_51viidesseitsemättä	sseitsemättä
NUM_51viidessentiljardis	ssentiljardis
NUM_51viidessentiljoonas	ssentiljoonas
NUM_51viidesseptiljardis	sseptiljardis
NUM_51viidesseptiljoonas	sseptiljoonas
NUM_51viidestoista	stoista
NUM_51viidestredekiljardis	stredekiljardis
NUM_51viidestredekiljoonas	stredekiljoonas
NUM_51viidestriljardis	striljardis
NUM_51viidestriljoonas	striljoonas
NUM_51viidestsiljardis	stsiljardis
NUM_51viidestsiljoonas	stsiljoonas
NUM_51viidestuhannes	stuhannes
NUM_51viidesundekiljardis	sundekiljardis
NUM_51viidesundekiljoonas	sundekiljoonas
NUM_51viidesviidettä	sviidettä
NUM_51viidesyhdeksättä	syhdeksättä
NUM_51viisibiljardia	sibiljardia
NUM_51viisibiljoonaa	sibiljoonaa
NUM_51viisidekiljardia	sidekiljardia
NUM_51viisidekiljoonaa	sidekiljoonaa
NUM_51viisiduodekiljardia	siduodekiljardia
NUM_51viisiduodekiljoonaa	siduodekiljoonaa
NUM_51viisikahdeksatta	sikahdeksatta
NUM_51viisikiljardia	sikiljardia
NUM_51viisikiljoonaa	sikiljoonaa
NUM_51viisikolmatta	sikolmatta
NUM_51viisikuudetta	sikuudetta
NUM_51viisikvadriljardia	sikvadriljardia
NUM_51viisikvadriljoonaa	sikvadriljoonaa
NUM_51viisikvintiljardia	sikvintiljardia
NUM_51viisikvintiljoonaa	sikvintiljoonaa
NUM_51viisikymmentä	sikymmentä
NUM_51viisimiljardia	similjardia
NUM_51viisimiljoonaa	similjoonaa
NUM_51viisineljättä	sineljättä
NUM_51viisinoniljardia	sinoniljardia
NUM_51viisinoniljoonaa	sinoniljoonaa
NUM_51viisioktiljardia	sioktiljardia
NUM_51viisioktiljoonaa	sioktiljoonaa
NUM_51viisipiljardia	sipiljardia
NUM_51viisipiljoonaa	sipiljoonaa
NUM_51viisisataa	sisataa
NUM_51viisiseitsemättä	siseitsemättä
NUM_51viisisentiljardia	sisentiljardia
NUM_51viisisentiljoonaa	sisentiljoonaa
NUM_51viisiseptiljardia	siseptiljardia
NUM_51viisiseptiljoonaa	siseptiljoonaa
NUM_51viisitoista	sitoista
NUM_51viisitredekiljardia	sitredekiljardia
NUM_51viisitredekiljoonaa	sitredekiljoonaa
NUM_51viisitriljardia	sitriljardia
NUM_51viisitriljoonaa	sitriljoonaa
NUM_51viisitsiljardia	sitsiljardia
NUM_51viisitsiljoonaa	sitsiljoonaa
NUM_51viisituhatta	situhatta
NUM_51viisiundekiljardia	siundekiljardia
NUM_51viisiundekiljoonaa	siundekiljoonaa
NUM_51viisiviidettä	siviidettä
NUM_51viisiyhdeksättä	siyhdeksättä
NUM_51yhdeksänbiljardia	änbiljardia
NUM_51yhdeksänbiljoonaa	änbiljoonaa
NUM_51yhdeksändekiljardia	ändekiljardia
NUM_51yhdeksändekiljoonaa	ändekiljoonaa
NUM_51yhdeksänduodekiljardia	änduodekiljardia
NUM_51yhdeksänduodekiljoonaa	änduodekiljoonaa
NUM_51yhdeksänkahdeksatta	änkahdeksatta
NUM_51yhdeksänkiljardia	änkiljardia
NUM_51yhdeksänkiljoonaa	änkiljoonaa
NUM_51yhdeksänkolmatta	änkolmatta
NUM_51yhdeksänkuudetta	änkuudetta
NUM_51yhdeksänkvadriljardia	änkvadriljardia
NUM_51yhdeksänkvadriljoonaa	änkvadriljoonaa
NUM_51yhdeksänkvintiljardia	änkvintiljardia
NUM_51yhdeksänkvintiljoonaa	änkvintiljoonaa
NUM_51yhdeksänkymmentä	änkymmentä
NUM_51yhdeksänmiljardia	änmiljardia
NUM_51yhdeksänmiljoonaa	änmiljoonaa
NUM_51yhdeksänneljättä	änneljättä
NUM_51yhdeksännoniljardia	ännoniljardia
NUM_51yhdeksännoniljoonaa	ännoniljoonaa
NUM_51yhdeksänoktiljardia	änoktiljardia
NUM_51yhdeksänoktiljoonaa	änoktiljoonaa
NUM_51yhdeksänpiljardia	änpiljardia
NUM_51yhdeksänpiljoonaa	änpiljoonaa
NUM_51yhdeksänsataa	änsataa
NUM_51yhdeksänseitsemättä	änseitsemättä
NUM_51yhdeksänsentiljardia	änsentiljardia
NUM_51yhdeksänsentiljoonaa	änsentiljoonaa
NUM_51yhdeksänseptiljardia	änseptiljardia
NUM_51yhdeksänseptiljoonaa	änseptiljoonaa
NUM_51yhdeksäntoista	äntoista
NUM_51yhdeksäntredekiljardia	äntredekiljardia
NUM_51yhdeksäntredekiljoonaa	äntredekiljoonaa
NUM_51yhdeksäntriljardia	äntriljardia
NUM_51yhdeksäntriljoonaa	äntriljoonaa
NUM_51yhdeksäntsiljardia	äntsiljardia
NUM_51yhdeksäntsiljoonaa	äntsiljoonaa
NUM_51yhdeksäntuhatta	äntuhatta
NUM_51yhdeksänundekiljardia	änundekiljardia
NUM_51yhdeksänundekiljoonaa	änundekiljoonaa
NUM_51yhdeksänviidettä	änviidettä
NUM_51yhdeksänyhdeksättä	änyhdeksättä
NUM_51yhdeksäsbiljardis	sbiljardis
NUM_51yhdeksäsbiljoonas	sbiljoonas
NUM_51yhdeksäsdekiljardis	sdekiljardis
NUM_51yhdeksäsdekiljoonas	sdekiljoonas
NUM_51yhdeksäsduodekiljardis	sduodekiljardis
NUM_51yhdeksäsduodekiljoonas	sduodekiljoonas
NUM_51yhdeksäskahdeksatta	skahdeksatta
NUM_51yhdeksäskiljardis	skiljardis
NUM_51yhdeksäskiljoonas	skiljoonas
NUM_51yhdeksäskolmatta	skolmatta
NUM_51yhdeksäskuudetta	skuudetta
NUM_51yhdeksäskvadriljardis	skvadriljardis
NUM_51yhdeksäskvadriljoonas	skvadriljoonas
NUM_51yhdeksäskvintiljardis	skvintiljardis
NUM_51yhdeksäskvintiljoonas	skvintiljoonas
NUM_51yhdeksäskymmenes	skymmenes
NUM_51yhdeksäsmiljardis	smiljardis
NUM_51yhdeksäsmiljoonas	smiljoonas
NUM_51yhdeksäsneljästtä	sneljästtä
NUM_51yhdeksäsnoniljardis	snoniljardis
NUM_51yhdeksäsnoniljoonas	snoniljoonas
NUM_51yhdeksäsoktiljardis	soktiljardis
NUM_51yhdeksäsoktiljoonas	soktiljoonas
NUM_51yhdeksäspiljardis	spiljardis
NUM_51yhdeksäspiljoonas	spiljoonas
NUM_51yhdeksässadas	ssadas
NUM_51yhdeksässeitsemättä	sseitsemättä
NUM_51yhdeksässentiljardis	ssentiljardis
NUM_51yhdeksässentiljoonas	ssentiljoonas
NUM_51yhdeksässeptiljardis	sseptiljardis
NUM_51yhdeksässeptiljoonas	sseptiljoonas
NUM_51yhdeksästoista	stoista
NUM_51yhdeksästredekiljardis	stredekiljardis
NUM_51yhdeksästredekiljoonas	stredekiljoonas
NUM_51yhdeksästriljardis	striljardis
NUM_51yhdeksästriljoonas	striljoonas
NUM_51yhdeksästsiljardis	stsiljardis
NUM_51yhdeksästsiljoonas	stsiljoonas
NUM_51yhdeksästuhannes	stuhannes
NUM_51yhdeksäsundekiljardis	sundekiljardis
NUM_51yhdeksäsundekiljoonas	sundekiljoonas
NUM_51yhdeksäsviidettä	sviidettä
NUM_51yhdeksäsyhdeksättä	syhdeksättä
NUM_51yhdeskahdeksatta	skahdeksatta
NUM_51yhdeskolmatta	skolmatta
NUM_51yhdeskuudetta	skuudetta
NUM_51yhdesneljästtä	sneljästtä
NUM_51yhdesseitsemättä	sseitsemättä
NUM_51yhdestoista	stoista
NUM_51yhdesviidettä	sviidettä
NUM_51yhdesyhdeksättä	syhdeksättä
NUM_51yksikahdeksatta	ksikahdeksatta
NUM_51yksikolmatta	ksikolmatta
NUM_51yksikuudetta	ksikuudetta
NUM_51yksineljättä	ksineljättä
NUM_51yksiseitsemättä	ksiseitsemättä
NUM_51yksitoista	ksitoista
NUM_51yksiviidettä	ksiviidettä
NUM_51yksiyhdeksättä	ksiyhdeksättä
NUM_ENSIMMÄINEN	nen
NUM_KAHDEKSAN	an
NUM_KAKSI	ksi
NUM_KOLMAS	s
NUM_KOLMASOSA	a
NUM_KOLME	e
NUM_KUUSI	si
NUM_KUUTISEN
NUM_KYMMEN
NUM_KYMMENEN	en
NUM_KYMMENKUNTA	a
NUM_KYMMENTÄ
NUM_MILJARDI	i
NUM_MILJOONA	a
NUM_NELJÄ	ä
NUM_NELJÄS	s
NUM_PARI	i
NUM_PUOLI	i
NUM_SATA	ta
NUM_TOINEN	nen
NUM_TUHAT	t
NUM_VIISI	si
NUM_VIITISEN
NUM_YHDEKSÄN	än
NUM_YKSI	ksi
PRON_AINOA	a
PRON_ERÄS	s
PRON_HÄN
PRON_HÄÄ	ä
PRON_IKINEN	nen
PRON_ITSE
PRON_JOKA	ka
PRON_JOKAINEN	nen
PRON_JOKIN	kin
PRON_JOKU	ku
PRON_JOMPIKUMPI	pikumpi
PRON_KAIKKI	ki
PRON_KOKO
PRON_KUKA	uka
PRON_KUKAAN	ukaan
PRON_KUKAKIN	ukakin
PRON_KUKIN	ukin
PRON_KUMPI	pi
PRON_KUMPIKAAN	pikaan
PRON_KUMPIKIN	pikin
PRON_MA
PRON_ME
PRON_MIE	e
PRON_MIKIN	kin
PRON_MIKÄ	kä
PRON_MIKÄKIN	käkin
PRON_MIKÄÄN	kään
PRON_MINÄ	nä
PRON_MOLEMMAT	mat
PRON_MONES	s
PRON_MONI	i
PRON_MONIAS	s
PRON_MONTA
PRON_MUU	u
PRON_MUUAN	n
PRON_MUUTAMA	a
PRON_MÄ	ä
PRON_MÄÄ
PRON_NE	e
PRON_NOI
PRON_NUO	uo
PRON_NÄMÄ	mä
PRON_SAMA	a
PRON_SE	e
PRON_TOI	i
PRON_TOINEN	nen
PRON_TUO	uo
PRON_TÄMÄ	mä
PRON_USEA	a
PRON_USEAMPI	pi
PRON_USEIMMAT	mmat
PRON_YKSI	ksi
PROPN_51Iso-Britannia	-Britannia
PROPN_51Mustameri	ameri
PROPN_51Punainenmeri	nenmeri
PROPN_51Tyynimeri	imeri
PROPN_51Uusikaupunki	sikaupunki
PROPN_51Uusimaa	simaa
PROPN_51Uusi-Seelanti	si-Seelanti
PROPN_A.
PROPN_AAKKOSELLISUUS	s
PROPN_AAKKOSTAMINEN	nen
PROPN_AALLOT	lot
PROPN_AARRE	re
PROPN_ACRO_AA
PROPN_ACRO_DOLLARI
PROPN_ACRO_EE
PROPN_ACRO_GRAMMA
PROPN_ACRO_II
PROPN_ACRO_JÄRJESTÖ
PROPN_ACRO_KAHDEKSAN
PROPN_ACRO_KAKSI
PROPN_ACRO_KANDELA
PROPN_ACRO_KOLME
PROPN_ACRO_KUUSI
PROPN_ACRO_LEHTI
PROPN_ACRO_METRI
PROPN_ACRO_NELJÄ
PROPN_ACRO_NOLLA
PROPN_ACRO_OO
PROPN_ACRO_PUNTA
PROPN_ACRO_SEITSEMÄN
PROPN_ACRO_UU
PROPN_ACRO_VIISI
PROPN_ACRO_WEBER
PROPN_ACRO_YHDEKSÄN
PROPN_ACRO_YKSI
PROPN_ACRO_YY
PROPN_ACRO_ZET
PROPN_ACRO_ÄKS
PROPN_ACRO_ÖÖ
PROPN_ACRO_Ω
PROPN_AHDET	det
PROPN_AIVOKUOLLUT	ut
PROPN_AIVOT	t
PROPN_AJATAR	ar
PROPN_ALKU	ku
PROPN_ALLAS	las
PROPN_ALTIS	is
PROPN_APE	e
PROPN_APU	pu
PROPN_ARISTOTELES	s
PROPN_ARKI	ki
PROPN_ASEMA	a
PROPN_ASKAR
PROPN_ASTE
PROPN_ASU
PROPN_ASUKAS	as
PROPN_ATERIMET	met
PROPN_BÉBÉ
PROPN_BEIGNET
PROPN_BERNIE
PROPN_BESSERWISSER
PROPN_BIDEE	e
PROPN_BIKINIT	t
PROPN_BORDEAUX
PROPN_BRASSERIE
PROPN_BRIE
PROPN_CAMUS
PROPN_CHACHACHA
PROPN_COMPOUND	-
PROPN_COWBOY
PROPN_DIMITRIS	s
PROPN_EKKE	ke
PROPN_ELIN	n
PROPN_ELÄMÄ	ä
PROPN_EPÄILTY	ty
PROPN_ESQUIMAU
PROPN_EUGENE
PROPN_FARKUT	ut
PROPN_FARMARIT	it
PROPN_FIFA
PROPN_FONDUE
PROPN_FÄNRIKIT	it
PROPN_GAY
PROPN_HAAKSI	ksi
PROPN_HAI	i
PROPN_HAIT	it
PROPN_HAMMAS	mas
PROPN_HAPPI	pi
PROPN_HAPPO	po
PROPN_HEITIN	in
PROPN_HENKI	ki
PROPN_HEPO	po
PROPN_HIIRI	i
PROPN_HIRTTO	to
PROPN_HIUTALEET	et
PROPN_HONKA	ka
PROPN_HOPEAT	at
PROPN_HORTA	ta
PROPN_HOUSUT	t
PROPN_HUOLITELTU	tu
PROPN_HUPI	pi
PROPN_HYLKY	ky
PROPN_HYÖTYY	y
PROPN_HÄIRIÖ
PROPN_HÄKKI	ki
PROPN_HÄKKYRÄ	ä
PROPN_HÄMET	t
PROPN_HÄMMINKI	ki
PROPN_HÄNNÄT	ät
PROPN_HÄNTÄ	tä
PROPN_HÄRKIN	n
PROPN_HÄÄT	ät
PROPN_HÄÄTÖ	tö
PROPN_HÖLKKÄ	kä
PROPN_HÖPÖTTÄJÄ	ä
PROPN_HÖYHENET	et
PROPN_INGET	get
PROPN_ITÄMAAT	at
PROPN_JEPPE	pe
PROPN_JOCKEY
PROPN_JOUKOT	ot
PROPN_JOUTSEN
PROPN_JUHLAT	at
PROPN_JUOVAT	vat
PROPN_JYLKYT	yt
PROPN_JÄRJESTÖT	t
PROPN_JÄRKI	ki
PROPN_JÄRVITAHDON	don
PROPN_JÄÄTELÖ
PROPN_KAARET	et
PROPN_KAARRET	ret
PROPN_KAARROT	rot
PROPN_KALATOIN	oin
PROPN_KANAALI	i
PROPN_KANGAS	gas
PROPN_KANGASALA	a
PROPN_KANKAHAT	hat
PROPN_KANNEL	nel
PROPN_KARRAT	rat
PROPN_KASTANJETIT	it
PROPN_KASTIKE	e
PROPN_KASTILJAT	at
PROPN_KAUSI	si
PROPN_KEHVELI	i
PROPN_KENGÄT	gät
PROPN_KENKÄ	kä
PROPN_KENTTÄ	tä
PROPN_KENTÄT	ät
PROPN_KERITSIMET	met
PROPN_KERTA	ta
PROPN_KEVÄT	t
PROPN_KIDE	de
PROPN_KIELTO	to
PROPN_KIERRE	re
PROPN_KIHARAT	t
PROPN_KIINNE	ne
PROPN_KILPI	pi
PROPN_KINNAS	nas
PROPN_KIRITTÄRET	täret
PROPN_KIRJA	a
PROPN_KIRVES	s
PROPN_KITARA	a
PROPN_KIVI	i
PROPN_KLUMPIT	it
PROPN_KOE	e
PROPN_KOKO	ko
PROPN_KOMPA	pa
PROPN_KORPI	pi
PROPN_KORTES	es
PROPN_KORTET	et
PROPN_KORTTI	ti
PROPN_KORVET	vet
PROPN_KOUVOT	t
PROPN_KREUS	s
PROPN_KUITU	tu
PROPN_KUMMUT	mut
PROPN_KUNGFU
PROPN_KUNNAT	nat
PROPN_KUNTA	ta
PROPN_KUOPAT	at
PROPN_KUOPPA	pa
PROPN_KUPPI	pi
PROPN_KUTSUNTA	ta
PROPN_KUULOKKEET	keet
PROPN_KUUS	s
PROPN_KYDÖT	döt
PROPN_KYKY	ky
PROPN_KYLKIÄINEN	nen
PROPN_KYLÄNVANHIN	n
PROPN_KYNNET	net
PROPN_KYNNÄÄT	ät
PROPN_KÄKI	ki
PROPN_KÄMMEKKÄ	kä
PROPN_KÄPY	py
PROPN_KÄPÄLÄ	ä
PROPN_KÄRJET	jet
PROPN_KÄRRY
PROPN_KÄRSÄKÄS	äs
PROPN_KÄRÄJÄT	t
PROPN_KÄSITE	e
PROPN_KÄÄNTÖ	tö
PROPN_KÖNGÄS	gäs
PROPN_KÖYHYYS	s
PROPN_KÖYSI	si
PROPN_KÖÖ	ö
PROPN_LAET	et
PROPN_LAHDET	det
PROPN_LAHTI	ti
PROPN_LAIDUN	dun
PROPN_LAKI	ki
PROPN_LAMMET	met
PROPN_LAMMI	pi
PROPN_LAMMIT	mit
PROPN_LANKA	ka
PROPN_LANNET	net
PROPN_LASIT	t
PROPN_LEHDET	det
PROPN_LEHTI	ti
PROPN_LEIKKUU	u
PROPN_LEIPÄ	pä
PROPN_LENTTEE	e
PROPN_LEPAKKO	ko
PROPN_LIEMI	mi
PROPN_LIITTOUTUNEET	et
PROPN_LIIVIT	t
PROPN_LINGOT	got
PROPN_LINTU	tu
PROPN_LIPEÄ	ä
PROPN_LIPOTTARET	taret
PROPN_LIPPU	pu
PROPN_LIUKU	ku
PROPN_LIVVADIEVÁT	t
PROPN_LOKA	ka
PROPN_LOKKI	ki
PROPN_LOMMOL	mol
PROPN_LOTTE	te
PROPN_LOUET	et
PROPN_LUHDAT	dat
PROPN_LUKU	ku
PROPN_LUMME	me
PROPN_LUODE	de
PROPN_LUODES	des
PROPN_LUOKKA	ka
PROPN_LUOLIKOT	ot
PROPN_LUPA	pa
PROPN_LUSIKKA	ka
PROPN_LÄHDES	des
PROPN_LÄHDET	det
PROPN_LÄHIN	n
PROPN_LÄNSI	si
PROPN_LÄÄKE	e
PROPN_LÖPÖ	pö
PROPN_MAA	a
PROPN_MAKKARA	a
PROPN_MAKU	ku
PROPN_MALKO	ko
PROPN_MALMÖ
PROPN_MARKKINAT	at
PROPN_MATEE	e
PROPN_MATKUET	et
PROPN_MC
PROPN_MERI	i
PROPN_MERTU	tu
PROPN_METTE	te
PROPN_MIEHET	het
PROPN_MIELENGE	ge
PROPN_MIELLE	le
PROPN_MIES	s
PROPN_MITTA	ta
PROPN_MONSIEUR
PROPN_MULTA	ta
PROPN_MURTEET	teet
PROPN_MYRKKY	ky
PROPN_MÄET	et
PROPN_MÄNNYT	nyt
PROPN_MÄNTY	ty
PROPN_MÄTTÄÄT	täät
PROPN_MÖMMÖ
PROPN_MÖRKÖ	kö
PROPN_NALLE
PROPN_NEUVOTTELUT	t
PROPN_NIEMET	t
PROPN_NIHTI	ti
PROPN_NIITUT	ut
PROPN_NIITYT	yt
PROPN_NIMETÖIN	töin
PROPN_NIMETÖN	tön
PROPN_NISSE
PROPN_NISSE
PROPN_NOKI	ki
PROPN_NOUGAT
PROPN_NUGAA	a
PROPN_NUKKE	ke
PROPN_NÄKY	ky
PROPN_NÄLKÄ	kä
PROPN_OLUT	t
PROPN_ONKI	ki
PROPN_ONNET	et
PROPN_ONNI	i
PROPN_OOKOO	o
PROPN_OPINNOT	not
PROPN_OSATON	ton
PROPN_OSOITE	e
PROPN_PAIKAT	at
PROPN_PANKIT	it
PROPN_PARFAIT
PROPN_PATA	ta
PROPN_PATEE	e
PROPN_PATSAS	s
PROPN_PEIPOT	ot
PROPN_PELKO	ko
PROPN_PELTI	ti
PROPN_PENGER	ger
PROPN_PIDOT	dot
PROPN_PII	i
PROPN_PIIROA	a
PROPN_PIPPALOT	t
PROPN_PISTE
PROPN_POHATTA	ta
PROPN_POHJE	je
PROPN_POIKA	ika
PROPN_POJAT	jat
PROPN_POLITIIKKA	ka
PROPN_PONSI	si
PROPN_PORRAS	ras
PROPN_PORTAAT	taat
PROPN_PROBLEEMA	a
PROPN_PUHELIN	n
PROPN_PUNK
PROPN_PUU	u
PROPN_PUUT	ut
PROPN_PYHTÄÄ	ä
PROPN_PYTTY	ty
PROPN_PYY	y
PROPN_PÄÄ	ä
PROPN_PÖKSYT	t
PROPN_PÖLHÄÄT	ät
PROPN_PÖLLÖT	t
PROPN_PÖNTTÖ	tö
PROPN_PÖYTÄ	tä
PROPN_RAGUU	u
PROPN_RAKENNE	ne
PROPN_RAMPA	pa
PROPN_RANGAT	gat
PROPN_RANNAT	nat
PROPN_RAPPE	pe
PROPN_RAPPUSET	set
PROPN_RAPUT	ut
PROPN_RATAS	as
PROPN_RAUDAT	dat
PROPN_RAUNIOT	t
PROPN_RAVUT	vut
PROPN_REGGAE
PROPN_REIKÄ	kä
PROPN_REIÄT	ät
PROPN_RENKAAT	kaat
PROPN_RIIPI	pi
PROPN_RIIVET	vet
PROPN_RIMMI	pi
PROPN_RIMMIT	mit
PROPN_RIMPI	pi
PROPN_RINNET	net
PROPN_RINTEET	teet
PROPN_RIPE	e
PROPN_RIPSET	et
PROPN_RIUTAT	at
PROPN_ROITOT	ot
PROPN_ROMPAAT	paat
PROPN_ROSÉ
PROPN_ROTTA	ta
PROPN_RUIPELO
PROPN_RUIS	is
PROPN_RUMPU	pu
PROPN_RUNKO	ko
PROPN_RUOKO	ko
PROPN_RUOPPAAT	paat
PROPN_RUUHI	i
PROPN_RUUMIS	s
PROPN_RUUVI	i
PROPN_RYPÄS	äs
PROPN_RYYPPY	py
PROPN_RÄJÄYTYS	s
PROPN_RÄMEET	et
PROPN_RÄMEÄT	ät
PROPN_RÄMIÄT	ät
PROPN_SAAPAS	as
PROPN_SAARET	et
PROPN_SAKSET	et
PROPN_SALONTEET	teet
PROPN_SALPA	pa
PROPN_SAMMALET	et
PROPN_SAMPI	pi
PROPN_SAMPO	po
PROPN_SEIKKAILU
PROPN_SEIVÄS	väs
PROPN_SELENE
PROPN_SELJÄT	jät
PROPN_SEPPÄ	pä
PROPN_SERGEJ
PROPN_SERKUKSET	kset
PROPN_SHOW
PROPN_SIEMEN
PROPN_SIIRTO	to
PROPN_SIIVILÄ	ä
PROPN_SILAKAT	at
PROPN_SILMÄKKEET	keet
PROPN_SISÄLTÖ	tö
PROPN_SIUNAAMATTOMAT	tomat
PROPN_SIVISTYNYT	yt
PROPN_SKEITTI	ti
PROPN_SOINTI	ti
PROPN_SOKEA	a
PROPN_SOTA	ta
PROPN_SPOTIFY
PROPN_STADION
PROPN_SUHTEET	teet
PROPN_SUKAT	at
PROPN_SULKA	ka
PROPN_SUODATIN	in
PROPN_SUOT	uot
PROPN_SYDÄN	n
PROPN_SYLI	i
PROPN_SYÖMINGIT	git
PROPN_SÄNKY	ky
PROPN_SÄRKÄT	ät
PROPN_SÄÄDIN	din
PROPN_SÄÄRET	et
PROPN_TAIMI	mi
PROPN_TAIVAL	val
PROPN_TALKOOT	ot
PROPN_TALO
PROPN_TARVE	ve
PROPN_TAUDIT	dit
PROPN_TAUTI	ti
PROPN_TAVAT	vat
PROPN_TEE	e
PROPN_TEHDAS	das
PROPN_TEHTAAT	taat
PROPN_TEKO	ko
PROPN_TIE	ie
PROPN_TIENOO	o
PROPN_TIETEET	teet
PROPN_TIHVII	i
PROPN_TIKKAAT	kaat
PROPN_TIKKU	ku
PROPN_TIPPA	pa
PROPN_TOIMET	et
PROPN_TOKEE	e
PROPN_TONGIT	git
PROPN_TORTTU	tu
PROPN_TOULAT	at
PROPN_TRIKOO	o
PROPN_TULI	i
PROPN_TUNTO	to
PROPN_TUOMIO
PROPN_TYTÄR	är
PROPN_TYTÖT	öt
PROPN_TYYLI	i
PROPN_TYYPPI	pi
PROPN_TYÖ	yö
PROPN_TYÖTTÖMÄT	tömät
PROPN_TÖLPÄKÖT	öt
PROPN_TÖLPÄT	ät
PROPN_TÖRPPÖ	pö
PROPN_UKKO	ko
PROPN_ULAPPA	pa
PROPN_VAADIN	din
PROPN_VAAKA	ka
PROPN_VAANII	i
PROPN_VAASAN
PROPN_VAINAA	a
PROPN_VAKUUTUS	s
PROPN_VALJAAT	at
PROPN_VALLAT	lat
PROPN_VALTA	ta
PROPN_VANHEMMAT	mat
PROPN_VANKI	ki
PROPN_VARAS	as
PROPN_VARAT	at
PROPN_VARPAAT	paat
PROPN_VARSI	si
PROPN_VARVAS	vas
PROPN_VEHKEILY
PROPN_VEITSI	tsi
PROPN_VELJET	jet
PROPN_VERSAILLES
PROPN_VETO	to
PROPN_VETY	ty
PROPN_VIENTI	ti
PROPN_VIHKIÄISET	set
PROPN_VIIRRET	ret
PROPN_VIIS	s
PROPN_VIIVE	ve
PROPN_VIKA	ka
PROPN_VINKU	ku
PROPN_VIRSI	si
PROPN_VODĂ	ă
PROPN_VOIMA	a
PROPN_VON
PROPN_VUO	uo
PROPN_VUODET	det
PROPN_VUOLLE	le
PROPN_VUOLLET	let
PROPN_VÄRTÖ	tö
PROPN_YHTIÖT	t
PROPN_YKSIKKÖ	kö
PROPN_YLÄNKÖ	kö
PROPN_YLÖÖ	ö
PROPN_YMPÄRYSTÄ	ä
PROPN_YRITTÄ	tä
PROPN_YSTÄVYKSET	kset
PROPN_YÖKKÖ	kö
PROPN_ZEN
PROPN_ZOMBIE
PROPN_ÄYRÄS	s
PUNCT_NONSTD_DASH_LOOP
PUNCT_NONSTD_EXCL_LOOP
PUNCT_PILKKU
PUNCT_PISTE
SCONJ_ETTÄ
SYM_,
SYM_.
SYM_§
SYM_¢
SYM_$
SYM_£
SYM_€
SYM_CELSIUS
SYM_GRAMMA
SYM_JOULE
SYM_METRI
SYM_TUOTE
SYM_WEBER
SYM_Ω
VERB_AALLOTA	lota
VERB_AHNEHTIA	tia
VERB_AMPUA	pua
VERB_ARVAILLA	illa
VERB_ARVATA	ta
VERB_AUTTAA	taa
VERB_DIGATA	ata
VERB_EHTIÄ	tiä
VERB_EI	ei
VERB_ENTÄÄ	tää
VERB_ERATA	ata
VERB_ETUILLA	la
VERB_HALAJAA	ta
VERB_HALJETA	jeta
VERB_HALUTA	ta
VERB_HAPATA	ata
VERB_HARPPOA	poa
VERB_HAUKKOA	koa
VERB_HELLITÄ	litä
VERB_HELPOTA	ota
VERB_HELÄJÄÄ	ää
VERB_HERMOTTUA	tua
VERB_HERÄTELLÄ	ellä
VERB_HIIPUA	pua
VERB_HIVENTÄÄ	tää
VERB_HUMALTUA	tua
VERB_HUONONTAA	taa
VERB_HUUTAA	taa
VERB_HYLJÄTÄ	jätä
VERB_HYLKIÄ	kiä
VERB_HYPELLÄ	ellä
VERB_HYPPIÄ	piä
VERB_HÄVÄISTÄ	väistä
VERB_ILJETÄ	jetä
VERB_INNOTA	nota
VERB_IRROTA	rota
VERB_ISÄNNÖIDÄ	idä
VERB_JAHDATA	data
VERB_JOUTAA	taa
VERB_JUOSTA	sta
VERB_JYRKETÄ	etä
VERB_JÄÄDÄ	ädä
VERB_KAATAA	taa
VERB_KAIKOTA	ota
VERB_KAIVATA	vata
VERB_KALPPIA	pia
VERB_KAMMETA	meta
VERB_KANTAA	taa
VERB_KARHETA	ta
VERB_KARHUTA	ta
VERB_KASVAA	aa
VERB_KAUNISTUA	a
VERB_KAVETA	veta
VERB_KERETÄ	etä
VERB_KERITÄ	itä
VERB_KIERTYÄ	tyä
VERB_KIETOA	toa
VERB_KIHERRELLÄ	rellä
VERB_KIILLELLÄ	lellä
VERB_KIINNETÄ	netä
VERB_KIITÄÄ	tää
VERB_KIRVOTA	vota
VERB_KIVETTYÄ	tyä
VERB_KIVETÄ	vetä
VERB_KIVISTÄÄ	ää
VERB_KIVUTA	vuta
VERB_KOMENNELLA	nella
VERB_KONTIA	tia
VERB_KOPIOIDA	ida
VERB_KORVETA	veta
VERB_KOSIA	ia
VERB_KOUKUTA	uta
VERB_KUHERTAA	taa
VERB_KUKKIA	kia
VERB_KUMMUTA	muta
VERB_KUTEA	tea
VERB_KYNTÄÄ	tää
VERB_KYTKEÄ	eä
VERB_KÄRKKYÄ	kyä
VERB_KÄYDÄ	ydä
VERB_KÄÄNNELLÄ	nellä
VERB_LASSOTA	ta
VERB_LEIKELLÄ	ellä
VERB_LEPPYÄ	pyä
VERB_LEPÄILLÄ	illä
VERB_LEUDOTA	dota
VERB_LEVÄTÄ	vätä
VERB_LIIDUTA	duta
VERB_LOBATA	ata
VERB_LOITOTA	ota
VERB_LOPPUA	pua
VERB_LOTOTA	ota
VERB_LUNTATA	ata
VERB_LUUTUTA	uta
VERB_LÄHTEÄ	hteä
VERB_LÄMMETÄ	metä
VERB_LÄMMITÄ	mitä
VERB_LÄNTÄTÄ	ätä
VERB_MARISTA	ta
VERB_MAUKUA	kua
VERB_MELLAKOIDA	ida
VERB_MENNÄ	nnä
VERB_MERKITÄ	tä
VERB_MIELTYÄ	tyä
VERB_MIETTIÄ	tiä
VERB_MOITTIA	tia
VERB_MOJAHTAA	taa
VERB_MORKATA	ata
VERB_MULLATA	lata
VERB_MUODOTA	dota
VERB_MUTRISTAA	aa
VERB_MYYDÄ	ydä
VERB_MÄDÄTÄ	dätä
VERB_MÄIKYÄ	kyä
VERB_MÖNKIÄ	kiä
VERB_NAKELLA	ella
VERB_NAKERRELLA	rella
VERB_NIUKETA	eta
VERB_NUOKKUA	kua
VERB_NÄHDÄ	hdä
VERB_NÄPERTÄÄ	tää
VERB_OLLA	olla
VERB_OMMELLA	mella
VERB_ONKIA	kia
VERB_PALKITA	ta
VERB_PANNA	nna
VERB_PEITOTA	ota
VERB_PENKOA	koa
VERB_PIDETÄ	detä
VERB_PIERRÄ	rä
VERB_PIESTÄ	stä
VERB_PINGOTA	gota
VERB_POIKETA	eta
VERB_POLKEA	kea
VERB_PUKEA	kea
VERB_PULPUTA	uta
VERB_PUNOA	a
VERB_PURKAA	kaa
VERB_PUSERTUA	tua
VERB_PYYTÄÄ	tää
VERB_PÄTEÄ	teä
VERB_RAAPIA	pia
VERB_RAIKAA	a
VERB_RANGAISTA	gaista
VERB_RENNOTA	nota
VERB_REVETÄ	vetä
VERB_RIIPIÄ	piä
VERB_ROHJETA	jeta
VERB_ROHTUA	tua
VERB_RYNNÄTÄ	nätä
VERB_RYPEÄ	peä
VERB_RYSKIÄ	iä
VERB_RYÖPYTÄ	ytä
VERB_RÄPSYTTÄÄ	tää
VERB_SAADA	ada
VERB_SAARTAA	taa
VERB_SAMMOTA	mota
VERB_SATAA	taa
VERB_SELVITÄ	tä
VERB_SIEPATA	ata
VERB_SILIYTYÄ	tyä
VERB_SILPOA	poa
VERB_SIVALTAA	taa
VERB_SORTAA	taa
VERB_SOTKEA	ea
VERB_SULATELLA	ella
VERB_SUPETA	eta
VERB_SURRA	ra
VERB_SUUNNATA	nata
VERB_SYÖDÄ	yödä
VERB_SYÖPYÄ	pyä
VERB_SÄILÖÄ	ä
VERB_SÄPSÄHDELLÄ	dellä
VERB_SÄRKEÄ	keä
VERB_SÖRKKIÄ	kiä
VERB_TAITAA	taa
VERB_TAKOA	koa
VERB_TAPELLA	ella
VERB_TAPPAA	paa
VERB_TEMMATA	mata
VERB_TEMPOA	poa
VERB_TIETÄÄ	tää
VERB_TIPAHDELLA	della
VERB_TODETA	deta
VERB_TUIKKAA	kaa
VERB_TULLA	lla
VERB_TUNGETA	geta
VERB_TUNKEA	kea
VERB_TUNTEA	tea
VERB_TUODA	uoda
VERB_TYHJENTYÄ	tyä
VERB_TYLPETÄ	etä
VERB_TYMPIÄ	piä
VERB_TÄHDÄTÄ	dätä
VERB_TÄHYTÄ	tä
VERB_ULOTA	ota
VERB_UPOTA	ota
VERB_VAAHDOTA	dota
VERB_VAELLELLA	lella
VERB_VAKAANTUA	tua
VERB_VARTOA	toa
VERB_VAVISTA	vista
VERB_VERRATA	rata
VERB_VIEDÄ	iedä
VERB_VIEROITTAA	taa
VERB_VIHELTÄÄ	tää
VERB_VIITTOA	toa
VERB_VINKUA	kua
VERB_VIPAJAA	aa
VERB_VIRKKAA	kaa
VERB_VONGATA	gata
VERB_VYYHDETÄ	detä
VERB_VÄHETÄ	tä
VERB_VÄLPÄTÄ	ätä
VERB_VÄNGÄTÄ	gätä
VERB_YLTÄÄ	tää
VERB_YNNÄTÄ	tä
VERB_YSKÄHTÄÄ	tää
VERB_YÖKÄTÄ	ätä
VERB_ÄHKÄÄ	ä
VERB_ÄKSYILLÄ	lä
VERB_ÄLLISTYÄ	ä
VERB_ÄNGETÄ	getä
VERB_ÄRISTÄ	tä
VERB_ÖYKKÄRÖIDÄ	idä
X_51eikä	ikä
X_51ettei	ei
X_51äläkä	äkä
X_FORGN_EN
X_FORGN_SV
