new_para	suffix_regex
ADJ_AAKKOSELLINEN	nen
ADJ_AAVA	a
ADJ_ABNORMAALI	i
ADJ_ABNORMI	i
ADJ_AHNE	e
ADJ_AIEMPI	mpi
ADJ_AINOA	oa
ADJ_AINUT	ut
ADJ_ALASTON	ton
ADJ_ÄLLISTYNYT	yt
ADJ_AUTIO	io
ADJ_AUTUAS	as
ADJ_AVOIN	n
ADJ_BEIGE	e
ADJ_EHTA	ta
ADJ_EHYT	yt
ADJ_GAY	ay
ADJ_HAILAKKA	kka
ADJ_HALPA	pa
ADJ_HÄPÄISTY	y
ADJ_HAPAN	pan
ADJ_HAPERA	a
ADJ_HARMAJA	a
ADJ_HARRAS	rras
ADJ_HELLE	lle
ADJ_HIDAS	das
ADJ_HOIKKA	kka
ADJ_HÖLÖ	ö
ADJ_HÖMPPÄ	ppä
ADJ_HÖPPÄNÄ	ä
ADJ_HUPAKKO	kko
ADJ_HURTTI	tti
ADJ_IKÄLOPPU	ppu
ADJ_JÄREÄ	eä
ADJ_KADE	de
ADJ_KÄYPÄ	pä
ADJ_KELPO	po
ADJ_KOHELO	o
ADJ_KÖKKÖ	kkö
ADJ_KOLKKO	kko
ADJ_KOLMAS	s
ADJ_KORKEA	ea
ADJ_KULTA	lta
ADJ_KULUNUT	ut
ADJ_KYLMÄJÄRKINEN	nen
ADJ_KYVYTÖN	tön
ADJ_KYYTTÖ	ttö
ADJ_LÄHEMPI	mpi
ADJ_LÄHTEISYYS	ys
ADJ_LAKO	ko
ADJ_LÄMMIN	mmin
ADJ_LÄNTÄ	ntä
ADJ_LATUSKA	a
ADJ_LÄTYSKÄ	ä
ADJ_LENKO	nko
ADJ_LÖPERÖ	ö
ADJ_LÖRPPÖ	ppö
ADJ_MÄRKÄ	kä
ADJ_MARTO	rto
ADJ_MATALA	a
ADJ_MÄTÄ	tä
ADJ_MATTA	tta
ADJ_MELTO	lto
ADJ_MENTY	nty
ADJ_MIETO	to
ADJ_MUU	uu
ADJ_MYKKÄ	kkä
ADJ_NELJÄS	s
ADJ_OHUT	ut
ADJ_OIKEE	ee
ADJ_OPAAKKI	kki
ADJ_ÖYKKÄRI	i
ADJ_PAHIN	in
ADJ_PANTU	ntu
ADJ_PARANNELTU	ltu
ADJ_PARAS	as
ADJ_PEEAA	aa
ADJ_PIENI	i
ADJ_PIERTY	rty
ADJ_PINKKI	kki
ADJ_PITKÄ	tkä
ADJ_POHATTA	tta
ADJ_POPPA	ppa
ADJ_PURTU	rtu
ADJ_RAAKA	ka
ADJ_RAITIS	tis
ADJ_RAMPA	mpa
ADJ_RÄVÄKKÄ	kkä
ADJ_REHTI	ti
ADJ_REIPAS	pas
ADJ_RIETAS	tas
ADJ_RIIVIÖ	iö
ADJ_RUMA	a
ADJ_SÄIKKY	kky
ADJ_SÄKKÄRÄ	ä
ADJ_SANKA	nka
ADJ_SIPPI	ppi
ADJ_SISIN	in
ADJ_STYDI	i
ADJ_SUIPPO	ppo
ADJ_SUOLISTETTAVA	a
ADJ_SUURI	i
ADJ_SYMPPIS	s
ADJ_SYYPÄÄ	ää
ADJ_TARKKA	ka
ADJ_TÄYSI	si
ADJ_TERÄVÄ	ä
ADJ_TERVE	e
ADJ_TIIVIS	is
ADJ_TOOPE	e
ADJ_TUHTI	ti
ADJ_TUMMAHKO	o
ADJ_TURTA	rta
ADJ_TYHMÄ	ä
ADJ_TYÖLÄS	äs
ADJ_TYÖLLISTETTÄVÄ	ä
ADJ_TYVEN	n
ADJ_TYYLIKÄS	käs
ADJ_UUSI	si
ADJ_VÄÄRTTI	tti
ADJ_VÄHÄTELTY	lty
ADJ_VALKAISTU	u
ADJ_VALMIS	is
ADJ_VÄNKÄ	nkä
ADJ_VAPAA	aa
ADJ_VASEN	n
ADJ_VELTTO	tto
ADJ_VENTO	nto
ADJ_VIATON	ton
ADJ_VIHANTA	nta
ADJ_VIIPALOITU	tu
ADJ_VIMMATTU	ttu
ADJ_VIRKKU	kku
ADJ_VOIMAKAS	kas
ADJ_VOIPA	pa
ADJ_YKSILÖITY	ty
ADJ_YLENNETTY	tty
ADP_ALLA	a
ADP_ALLE	e
ADP_HYVILLÄÄN	än
ADP_ILKOSILLAAN	an
ADP_ISTUALLEEN	en
ADP_KOTONA	.
ADP_LISÄKSI	ksi
ADP_LÄHELLÄ	ä
ADP_MUKAAN	n
ADP_MUKAISESTI	.
ADP_NÄHDEN	den
ADP_NÄKYVIIN	n
ADP_TYKÖ	.
ADP_VALTAAN	n
ADP_VUOKSI	ksi
ADP_YLLE	e
ADV_AIKANSA	.
ADV_IKINÄ	.
ADV_JO	.
ADV_JONNE	.
ADV_KUHUN	.
ADV_LEVÄLLEEN	.
ADV_MITEN	.
ADV_NOPEASTI	.
ADV_TYHMÄSTI	.
ADV_VAAN	.
ADV_YLIPÄÄNSÄ	.
AUX_AIKOA	aikoa
AUX_JOUTUA	joutua
AUX_MAHTAA	mahtaa
AUX_OLLA	olla
AUX_PITÄÄ	pitää
AUX_SAATTAA	saattaa
AUX_TAITAA	taitaa
AUX_TARVITA	tarvita
AUX_TÄYTYÄ	täytyä
AUX_VOIDA	voida
CONJ_JA	.
DET_SE	.
DET_YKSI	.
INTJ_HAH	.
INTJ_OO	.
NOUN_51aavameri	aavameri
NOUN_51hienosokeri	hienosokeri
NOUN_51isojako	isojako
NOUN_51isokäpylintu	isokäpylintu
NOUN_51isokoskelo	isokoskelo
NOUN_51isokuovi	isokuovi
NOUN_51isolepinkäinen	isolepinkäinen
NOUN_51isolokki	isolokki
NOUN_51isomaksaruoho	isomaksaruoho
NOUN_51isomasto	isomasto
NOUN_51isopanda	isopanda
NOUN_51isopistooli	isopistooli
NOUN_51isopurje	isopurje
NOUN_51isorokko	isorokko
NOUN_51isorumpu	isorumpu
NOUN_51isosisar	isosisar
NOUN_51isosisko	isosisko
NOUN_51isotaivot	isotaivot
NOUN_51isovarvas	isovarvas
NOUN_51isoveli	isoveli
NOUN_51isoviha	isoviha
NOUN_51karkearehu	karkearehu
NOUN_51kevytsarja	kevytsarja
NOUN_51kirjavapillike	kirjavapillike
NOUN_51kuivakakku	kuivakakku
NOUN_51kuivakukka	kuivakukka
NOUN_51kuivamuona	kuivamuona
NOUN_51kuivapaino	kuivapaino
NOUN_51kuivapari	kuivapari
NOUN_51kuivarehu	kuivarehu
NOUN_51kultainennoutaja	kultainennoutaja
NOUN_51laiskakoira	laiskakoira
NOUN_51lämminruoka	lämminruoka
NOUN_51lämminvarasto	lämminvarasto
NOUN_51lämminvaunu	lämminvaunu
NOUN_51matalameri	matalameri
NOUN_51mustaherukka	mustaherukka
NOUN_51mustaleipä	mustaleipä
NOUN_51mustaleski	mustaleski
NOUN_51mustalintu	mustalintu
NOUN_51mustamaija	mustamaija
NOUN_51mustamakkara	mustamakkara
NOUN_51mustamies	mustamies
NOUN_51mustamulta	mustamulta
NOUN_51mustapekka	mustapekka
NOUN_51mustapippuri	mustapippuri
NOUN_51mustaraamattu	mustaraamattu
NOUN_51mustatorvisieni	mustatorvisieni
NOUN_51mustaviinimarja	mustaviinimarja
NOUN_51nuoriemäntä	nuoriemäntä
NOUN_51nuoriherra	nuoriherra
NOUN_51nuori-isäntä	nuori-isäntä
NOUN_51nuorikarja	nuorikarja
NOUN_51nuorimies	nuorimies
NOUN_51nuoripari	nuoripari
NOUN_51omakuva	omakuva
NOUN_51omatunto	omatunto
NOUN_51pahahenki	pahahenki
NOUN_51pahaputki	pahaputki
NOUN_51palavakivi	palavakivi
NOUN_51palavapensas	palavapensas
NOUN_51palavarakkaus	palavarakkaus
NOUN_51pitkähousu	pitkähousu
NOUN_51pitkäkirkko	pitkäkirkko
NOUN_51pitkäperjantai	pitkäperjantai
NOUN_51pitkäpiimä	pitkäpiimä
NOUN_51pitkäsiima	pitkäsiima
NOUN_51pitkätakki	pitkätakki
NOUN_51pitkäthousut	pitkäthousut
NOUN_51puolikuu	puolikuu
NOUN_51puolimatka	puolimatka
NOUN_51puolipäivä	puolipäivä
NOUN_51puoliväli	puoliväli
NOUN_51puoliyö	puoliyö
NOUN_51raitisilma	raitisilma
NOUN_51raskassarja	raskassarja
NOUN_51raskasvesi	raskasvesi
NOUN_51raskasvety	raskasvety
NOUN_51särkynytsydän	särkynytsydän
NOUN_51sepiväpeippi	sepiväpeippi
NOUN_51suorakulma	suorakulma
NOUN_51suoraommel	suoraommel
NOUN_51syvämeri	syvämeri
NOUN_51täysikuu	täysikuu
NOUN_51tyhjäpaino	tyhjäpaino
NOUN_51uusikuu	uusikuu
NOUN_51uusivuosi	uusivuosi
NOUN_51vanhaemäntä	vanhaemäntä
NOUN_51vanhaisäntä	vanhaisäntä
NOUN_51vanhakaupunki	vanhakaupunki
NOUN_51vanhapiika	vanhapiika
NOUN_51vanhapoika	vanhapoika
NOUN_51vierasmies	vierasmies
NOUN_AAKKOSELLISUUS	us
NOUN_AAKKOSTAMINEN	nen
NOUN_AALLOT	lot
NOUN_AAMUKAHDEKSAN	kahdeksan
NOUN_AAMUKOLME	kolme
NOUN_AAMUKYMMENEN	kymmenen
NOUN_AAMUYHDEKSÄN	än
NOUN_AAMUYKSI	yksi
NOUN_AARRE	rre
NOUN_ACRO_AA	[Aa]
NOUN_ACRO_ÄÄ	[Ää]
NOUN_ACRO_ÄKS	[FLMNRŠSXŽflmnršsxž²³]
NOUN_ACRO_CELSIUS	.
NOUN_ACRO_DOLLARI	.
NOUN_ACRO_EE	[BCDEGPTVWbcdegptvw]
NOUN_ACRO_GRAMMA	.
NOUN_ACRO_GRAMMA	.
NOUN_ACRO_GRAY	.
NOUN_ACRO_II	[IJij]
NOUN_ACRO_JÄRJESTÖ	.
NOUN_ACRO_JOULE	.
NOUN_ACRO_KAHDEKSAN	8
NOUN_ACRO_KAKSI	2
NOUN_ACRO_KANDELA	.
NOUN_ACRO_KOLMAS	.
NOUN_ACRO_KOLME	3
NOUN_ACRO_KUUSI	6
NOUN_ACRO_LEHTI	.
NOUN_ACRO_LUSIKKA	.
NOUN_ACRO_METRI	.
NOUN_ACRO_NELJÄ	4
NOUN_ACRO_NOLLA	0
NOUN_ACRO_OIKEUS	.
NOUN_ACRO_OK	.
NOUN_ACRO_OO	[HKOÅhkoå]
NOUN_ACRO_ÖÖ	[Öö]
NOUN_ACRO_OPISTO	.
NOUN_ACRO_OPPILAS	.
NOUN_ACRO_PUNTA	.
NOUN_ACRO_SAIRAALA	.
NOUN_ACRO_SEITSEMÄN	.
NOUN_ACRO_TUOTE	.
NOUN_ACRO_UU	[QUqu]
NOUN_ACRO_VIISI	5
NOUN_ACRO_VUOSI	.
NOUN_ACRO_WEBER	.
NOUN_ACRO_YHDEKSÄN	9
NOUN_ACRO_YHDISTYS	.
NOUN_ACRO_YKSI	1
NOUN_ACRO_YY	[YÜyü]
NOUN_ACRO_ZET	[ZŽzž]
NOUN_ACRO_Ω	.
NOUN_AHDET	det
NOUN_AIKA	ika
NOUN_AIVOKUOLLUT	ut
NOUN_AIVOT	ot
NOUN_AJATAR	tar
NOUN_ALKEET	keet
NOUN_ALKU	ku
NOUN_ALLAS	las
NOUN_ALTIS	tis
NOUN_ANTIMET	ntimet
NOUN_APE	e
NOUN_APU	pu
NOUN_ARISTOTELES	es
NOUN_ARKI	ki
NOUN_ASEMA	a
NOUN_ASKAR
NOUN_ASKELLIN	llin
NOUN_ASTE	e
NOUN_ASUKAS	kas
NOUN_ASU	[Uuú]
NOUN_ATERIMET	met
NOUN_AUER	er
NOUN_ÄYRÄS	äs
NOUN_BÄNET	et
NOUN_BÉBÉ
NOUN_BEIGNET
NOUN_BERNIE	e
NOUN_BESSERWISSER
NOUN_BIDEE	ee
NOUN_BIKINIT	it
NOUN_BORDEAUX
NOUN_BRASSERIE
NOUN_BRIE
NOUN_CAMUS
NOUN_CHACHACHA
NOUN_COMPOUND	.
NOUN_COWBOY
NOUN_DIMITRIS	s
NOUN_EKKE	ke
NOUN_ELÄMÄ	ä
NOUN_ELIN	n
NOUN_EPÄILTY	lty
NOUN_ESIM.	\.
NOUN_ESQUIMAU
NOUN_EUGENE
NOUN_FÄNRIKIT	it
NOUN_FARKUT	ut
NOUN_FARMARIT	it
NOUN_FIFA
NOUN_FONDUE
NOUN_FONDYY	yy
NOUN_GAY
NOUN_HAAKSI	ksi
NOUN_HÄÄT	äät
NOUN_HÄÄTÖ	tö
NOUN_HAI	i
NOUN_HÄIRIÖ	ö
NOUN_HAIT	it
NOUN_HÄKKI	ki
NOUN_HÄKKYRÄ	ä
NOUN_HÄMET	t
NOUN_HAMMAS	mmas
NOUN_HÄMMINKI	nki
NOUN_HÄNNÄT	nnät
NOUN_HÄNTÄ	ntä
NOUN_HAPAN	pan
NOUN_HAPPI	ppi
NOUN_HAPPO	ppo
NOUN_HAPSI	psi
NOUN_HÄRKIN	n
NOUN_HARMAAT	aat
NOUN_HÄVINNEET	neet
NOUN_HEITIN	tin
NOUN_HENKI	nki
NOUN_HEPO	po
NOUN_HIIRI	i
NOUN_HIPAT	pat
NOUN_HIRTTO	tto
NOUN_HIUTALEET	eet
NOUN_HOKSOTTIMET	et
NOUN_HÖLKKÄ	kkä
NOUN_HONKA	nka
NOUN_HOPEAT	eat
NOUN_HÖPÖTTÄJÄ	ä
NOUN_HORTA	rta
NOUN_HOUSUT	ut
NOUN_HÖYHENET	et
NOUN_HUOLITELTU	ltu
NOUN_HUPI	pi
NOUN_HYLJE	je
NOUN_HYLKY	ky
NOUN_HYNTTEET	tteet
NOUN_HYNTTYYT	ttyyt
NOUN_HYÖTYY	yy
NOUN_IEN	en
NOUN_IES	es
NOUN_IKENET	kenet
NOUN_IMMYT	mmyt
NOUN_INGET	nget
NOUN_ITÄMAAT	aat
NOUN_JÄÄTELÖ	ö
NOUN_JÄLSI	lsi
NOUN_JÄRJESTÖT	öt
NOUN_JÄRKI	ki
NOUN_JÄRVITAHDON	don
NOUN_JEPPE	ppe
NOUN_JOCKEY
NOUN_JOUKOT	ot
NOUN_JOUTSEN
NOUN_JUHLAT	at
NOUN_JUMALA	a
NOUN_JUOVAT	vat
NOUN_JYLKYT	kyt
NOUN_KÄÄDYT	dyt
NOUN_KÄÄNNIN	nnin
NOUN_KÄÄNTÖ	ntö
NOUN_KAARET	et
NOUN_KAARRET	rret
NOUN_KAARROT	rrot
NOUN_KÄKI	ki
NOUN_KALATOIN	toin
NOUN_KÄMMEKKÄ	kkä
NOUN_KAMPPEET	ppeet
NOUN_KANAALI	i
NOUN_KANGASALA	a
NOUN_KANGAS	ngas
NOUN_KANKAHAT	hat
NOUN_KANNEL	nnel
NOUN_KANNET	nnet
NOUN_KÄPÄLÄ	ä
NOUN_KÄPY	py
NOUN_KÄRÄJÄT	ät
NOUN_KÄRJET	jet
NOUN_KARRAT	rrat
NOUN_KÄRRY	[YÜyÿü]
NOUN_KÄRSÄKÄS	käs
NOUN_KÄSITE	e
NOUN_KASTANJETIT	tit
NOUN_KASTIKE	ke
NOUN_KASTILJAT	at
NOUN_KAUSI	si
NOUN_KEHVELI	i
NOUN_KELTIS	tis
NOUN_KENGÄT	ngät
NOUN_KENKÄ	nkä
NOUN_KENTÄT	tät
NOUN_KENTTÄ	ttä
NOUN_KERITSIMET	met
NOUN_KERROIN	rroin
NOUN_KERTA	rta
NOUN_KEVÄT	t
NOUN_KIDE	de
NOUN_KIELTO	lto
NOUN_KIERRE	rre
NOUN_KIERRIN	rrin
NOUN_KIHARAT	at
NOUN_KIHARRIN	rrin
NOUN_KIINNE	nne
NOUN_KIIRU	u
NOUN_KILPIKKÄÄT	kkäät
NOUN_KILPI	pi
NOUN_KINNAS	nnas
NOUN_KINNER	nner
NOUN_KIRITTÄRET	ttäret
NOUN_KIRJA	a
NOUN_KIRVES	es
NOUN_KITARA	a
NOUN_KIVI	i
NOUN_KLUMPIT	pit
NOUN_KOE	e
NOUN_KOKO	ko
NOUN_KOMPA	mpa
NOUN_KÖNGÄS	ngäs
NOUN_KÖÖ	öö
NOUN_KORPI	pi
NOUN_KORTES	tes
NOUN_KORTET	tet
NOUN_KORTTI	tti
NOUN_KORVET	vet
NOUN_KOUVOT	ot
NOUN_KÖYHYYS	ys
NOUN_KÖYSI	si
NOUN_KREUS	us
NOUN_KUITU	tu
NOUN_KUMMUT	mmut
NOUN_KUNGFU
NOUN_KUNNAT	nnat
NOUN_KUNTA	nta
NOUN_KUOPAT	pat
NOUN_KUOPPA	ppa
NOUN_KUPPI	ppi
NOUN_KUTSUNTA	nta
NOUN_KUULOKKEET	keet
NOUN_KUUS	s
NOUN_KYDÖT	döt
NOUN_KYKY	yky
NOUN_KYLÄNVANHIN	n
NOUN_KYLKIÄINEN	nen
NOUN_KYNNÄÄT	äät
NOUN_KYNNET	nnet
NOUN_KYSYNTÄ	ntä
NOUN_KYYNEL	l
NOUN_LÄÄKE	ke
NOUN_LAET	et
NOUN_LÄHDES	des
NOUN_LAHDET	det
NOUN_LÄHDET	det
NOUN_LÄHIN	in
NOUN_LAHTI	ti
NOUN_LAIDUN	dun
NOUN_LAKI	ki
NOUN_LAMMET	mmet
NOUN_LAMMI	mpi
NOUN_LÄMMIN	min
NOUN_LAMMIT	mmit
NOUN_LÄMPÖ	mpö
NOUN_LÄNGET	nget
NOUN_LANKA	nka
NOUN_LANNET	nnet
NOUN_LÄNSI	nsi
NOUN_LAPSI	psi
NOUN_LASIT	t
NOUN_LEHDET	det
NOUN_LEHTI	ti
NOUN_LEIKKUU	uu
NOUN_LEIPÄ	pä
NOUN_LENTTEE	ee
NOUN_LEPAKKO	kko
NOUN_LIEMI	mi
NOUN_LIITTOUTUNEET	neet
NOUN_LIIVIT	it
NOUN_LINGOT	ngot
NOUN_LINTU	ntu
NOUN_LIPEÄ	eä
NOUN_LIPOTTARET	ttaret
NOUN_LIPPU	ppu
NOUN_LIUKU	uku
NOUN_LIVVADIEVÁT	át
NOUN_LOKA	ka
NOUN_LOKKI	kki
NOUN_LOMMOL	mol
NOUN_LÖPÖ	pö
NOUN_LOTTE	tte
NOUN_LOUET	uet
NOUN_LUHDAT	dat
NOUN_LUKU	uku
NOUN_LUMME	mme
NOUN_LUODE	de
NOUN_LUODES	des
NOUN_LUOKKA	kka
NOUN_LUOLIKOT	kot
NOUN_LUPA	pa
NOUN_LUSIKKA	kka
NOUN_MAA	aa
NOUN_MÄET	et
NOUN_MAKKARA	a
NOUN_MAKU	ku
NOUN_MALKO	ko
NOUN_MALTAAT	ltaat
NOUN_MANNER	nner
NOUN_MÄNNYT	nnyt
NOUN_MÄNTY	nty
NOUN_MARKKINAT	at
NOUN_MÄTÄS	täs
NOUN_MATEE	e
NOUN_MATKUET	et
NOUN_MÄTTÄÄT	ttäät
NOUN_MERI	i
NOUN_MERTU	rtu
NOUN_METTE	tte
NOUN_MIEHET	iehet
NOUN_MIELENGE	nge
NOUN_MIELLE	lle
NOUN_MIES	ies
NOUN_MILJÖÖ	öö
NOUN_MILJÖÖT	ööt
NOUN_MITTA	tta
NOUN_MÖMMÖ	ö
NOUN_MONSIEUR
NOUN_MÖRKÖ	kö
NOUN_MULTA	lta
NOUN_MURTEET	rteet
NOUN_MUUNNIN	nnin
NOUN_MYRKKY	kky
NOUN_NÄKÖ	kö
NOUN_NÄKY	ky
NOUN_NÄLKÄ	kä
NOUN_NALLE	[Eeëěĕ]
NOUN_NEITSYT	yt
NOUN_NEUVOTTELUT	ut
NOUN_NIEMET	et
NOUN_NIHTI	ti
NOUN_NIITUT	tut
NOUN_NIITYT	tyt
NOUN_NIMETÖIN	töin
NOUN_NIMETÖN	tön
NOUN_NISSE	[Eeěë]
NOUN_NOKI	ki
NOUN_NOUGAT
NOUN_NUGAA	aa
NOUN_NUKKE	kke
NOUN_NYLJIN	jin
NOUN_OIKEUDET	det
NOUN_OLKA	ka
NOUN_OLUT	ut
NOUN_OMMEL	mmel
NOUN_ONKI	ki
NOUN_ONNET	net
NOUN_ONNI	i
NOUN_OOKOO	oo
NOUN_OPINNOT	nnot
NOUN_ORI	i
NOUN_OSATON	ton
NOUN_OSOITE	e
NOUN_PÄÄ	ää
NOUN_PAIKAT	at
NOUN_PANKIT	kit
NOUN_PARFAIT
NOUN_PATA	ta
NOUN_PATEE	ee
NOUN_PATSAS	as
NOUN_PEIPOT	pot
NOUN_PELKO	ko
NOUN_PELTI	lti
NOUN_PENGER	nger
NOUN_PERKEET	keet
NOUN_PIDOT	dot
NOUN_PIENNAR	nnar
NOUN_PIHDIT	dit
NOUN_PII	i
NOUN_PIIROA	[ôo]a
NOUN_PINSETIT	tit
NOUN_PIPPALOT	ot
NOUN_PISTE
NOUN_POHATTA	tta
NOUN_POHJE	je
NOUN_POIKA	oika
NOUN_POIUT	ut
NOUN_POJAT	ojat
NOUN_PÖKSYT	yt
NOUN_PÖLHÄÄT	äät
NOUN_POLITIIKKA	kka
NOUN_POLJIN	jin
NOUN_PÖLLÖT	öt
NOUN_PONSI	nsi
NOUN_PÖNTTÖ	ttö
NOUN_PORRAS	rras
NOUN_PORTAAT	rtaat
NOUN_PÖYTÄ	tä
NOUN_PROBLEEMA	a
NOUN_PUHELIN	n
NOUN_PUIN	in
NOUN_PUKIMET	kimet
NOUN_PUNK
NOUN_PUUT	uut
NOUN_PUU	u
NOUN_PYHTÄÄ	ää
NOUN_PYTTY	tty
NOUN_PYYHE	e
NOUN_PYYHIN	in
NOUN_PYYT	yyt
NOUN_PYY	yy
NOUN_RAAVIN	vin
NOUN_RAGUU	uu
NOUN_RÄJÄYTYS	s
NOUN_RAKENNE	ne
NOUN_RÄMEÄT	eät
NOUN_RÄMEET	eet
NOUN_RÄMIÄT	ät
NOUN_RAMPA	mpa
NOUN_RANGAT	ngat
NOUN_RANNAT	nnat
NOUN_RAPPE	ppe
NOUN_RAPPUSET	set
NOUN_RAPUT	put
NOUN_RATAS	tas
NOUN_RATTAAT	ttaat
NOUN_RAUDAT	dat
NOUN_RAUNIOT	ot
NOUN_RAVET	et
NOUN_RAVUT	vut
NOUN_REGGAE
NOUN_REIÄT	ät
NOUN_REIKÄ	kä
NOUN_RENKAAT	kaat
NOUN_RIIPI	pi
NOUN_RIIVET	vet
NOUN_RIMMI	mpi
NOUN_RIMMIT	mmit
NOUN_RIMPI	mpi
NOUN_RINNET	nnet
NOUN_RINTEET	nteet
NOUN_RIPE	pe
NOUN_RIPSET	et
NOUN_RIUTAT	tat
NOUN_ROHTIMET	timet
NOUN_ROITOT	tot
NOUN_ROMPAAT	paat
NOUN_ROSÉ
NOUN_ROTAT	tat
NOUN_ROTTA	tta
NOUN_RUIPELO	o
NOUN_RUIS	is
NOUN_RUMPU	mpu
NOUN_RUNKO	nko
NOUN_RUOKA	uoka
NOUN_RUOKO	oko
NOUN_RUOPPAAT	ppaat
NOUN_RUUHI	i
NOUN_RUUMIS	is
NOUN_RUUVI	i
NOUN_RYNNÄS	nnäs
NOUN_RYNTÄÄT	täät
NOUN_RYNTTYYT	ttyyt
NOUN_RYPÄS	päs
NOUN_RYYPPY	ppy
NOUN_SÄÄDIN	din
NOUN_SÄÄNNÖT	nnöt
NOUN_SAAPAS	pas
NOUN_SAARET	et
NOUN_SÄÄRET	et
NOUN_SÄEN	en
NOUN_SAKSET	et
NOUN_SALONTEET	nteet
NOUN_SALPA	pa
NOUN_SAMMALET	et
NOUN_SAMPI	mpi
NOUN_SAMPO	mpo
NOUN_SANKARI	i
NOUN_SÄNKY	nky
NOUN_SÄRKÄT	kät
NOUN_SÄRVIN	vin
NOUN_SEIKKAILU	u
NOUN_SEIVÄS	väs
NOUN_SELENE
NOUN_SELJÄT	jät
NOUN_SEPPÄ	ppä
NOUN_SERGEJ	j
NOUN_SERKUKSET	kset
NOUN_SHOW
NOUN_SIEMEN
NOUN_SIIRTO	rto
NOUN_SIIVILÄ	ä
NOUN_SILAKAT	kat
NOUN_SILMÄKKEET	keet
NOUN_SISÄLTÖ	ltö
NOUN_SIUNAAMATTOMAT	ttomat
NOUN_SIVELLIN	llin
NOUN_SIVISTYNYT	nyt
NOUN_SKEITTI	tti
NOUN_SOINTI	nti
NOUN_SOKEA	ea
NOUN_SOTA	ta
NOUN_SPOTIFY
NOUN_STADION
NOUN_SUHTEET	teet
NOUN_SUKAT	kat
NOUN_SULKA	ka
NOUN_SUODATIN	tin
NOUN_SUOT	uot
NOUN_SYDÄN	n
NOUN_SYLI	i
NOUN_SYLTÄ	tä
NOUN_SYNNYTTIMET	ttimet
NOUN_SYÖMINGIT	ngit
NOUN_TAIMI	mi
NOUN_TAIVAL	val
NOUN_TALKOOT	oot
NOUN_TALO	[Oo]
NOUN_TANHUA	ua
NOUN_TARPEET	peet
NOUN_TARVE	ve
NOUN_TAUDIT	dit
NOUN_TAUTI	ti
NOUN_TAVAT	vat
NOUN_TEE	[ée]e
NOUN_TEHDAS	das
NOUN_TEHTAAT	taat
NOUN_TEKO	ko
NOUN_TIE	ie
NOUN_TIENOO	oo
NOUN_TIETEET	teet
NOUN_TIET	iet
NOUN_TIHVII	ii
NOUN_TIKKAAT	kaat
NOUN_TIKKU	kku
NOUN_TIPPA	ppa
NOUN_TOIMET	et
NOUN_TOKEE	ee
NOUN_TÖLPÄKÖT	köt
NOUN_TÖLPÄT	pät
NOUN_TONGIT	git
NOUN_TÖRPPÖ	ppö
NOUN_TORTTU	tu
NOUN_TOULAT	at
NOUN_TRIKOO	oo
NOUN_TUHKA	hka
NOUN_TULI	i
NOUN_TUNNIT	nnit
NOUN_TUNTO	nto
NOUN_TUOMIO	o
NOUN_TYÖTTÖMÄT	ttömät
NOUN_TYÖT	yöt
NOUN_TYÖ	yö
NOUN_TYPPI	ppi
NOUN_TYTÄR	tär
NOUN_TYTÖT	töt
NOUN_TYYLI	i
NOUN_TYYPPI	ppi
NOUN_UDAR	dar
NOUN_UKKO	kko
NOUN_UKSI	ksi
NOUN_ULAPPA	ppa
NOUN_UROS	os
NOUN_VAADIN	din
NOUN_VAAKA	ka
NOUN_VAANII	i
NOUN_VAATTEET	tteet
NOUN_VAINAA	aa
NOUN_VAKUUTUS	s
NOUN_VALJAAT	aat
NOUN_VALLAT	llat
NOUN_VALTA	lta
NOUN_VANHEMMAT	mmat
NOUN_VANHEMPI	mpi
NOUN_VANKI	nki
NOUN_VANTUS	tus
NOUN_VARAS	as
NOUN_VARAT	at
NOUN_VARPAAT	paat
NOUN_VARSI	rsi
NOUN_VÄRTÖ	rtö
NOUN_VARVAS	vas
NOUN_VASEN	en
NOUN_VEHKEILY	y
NOUN_VEITSI	tsi
NOUN_VELI	eli
NOUN_VELJET	eljet
NOUN_VEMMEL	mmel
NOUN_VERI	eri
NOUN_VERSAILLES
NOUN_VETIMET	timet
NOUN_VETO	to
NOUN_VETY	ty
NOUN_VIENTI	nti
NOUN_VIHKIÄISET	set
NOUN_VIHKO	hko
NOUN_VIIRRET	rret
NOUN_VIIS	s
NOUN_VIIVE	ve
NOUN_VIKA	ka
NOUN_VINKU	nku
NOUN_VIRRET	rret
NOUN_VIRSI	rsi
NOUN_VOIMA	a
NOUN_VUODET	det
NOUN_VUOLLE	lle
NOUN_VUOLLET	llet
NOUN_VUOSITUHAT	t
NOUN_VUO	uo
NOUN_YHTIÖT	t
NOUN_YKSIKKÖ	kkö
NOUN_YLÄNKÖ	nkö
NOUN_YLKÄ	kä
NOUN_YLÖÖ	öö
NOUN_YMPÄRYSTÄ	ä
NOUN_YÖKKÖ	kkö
NOUN_YRITTÄ	ttä
NOUN_YSTÄVYKSET	kset
NOUN_ZEN
NOUN_ZOMBIE	e
NUM_51kahdeksanbiljardia	kahdeksanbiljardia
NUM_51kahdeksanbiljoonaa	kahdeksanbiljoonaa
NUM_51kahdeksandekiljardia	kahdeksandekiljardia
NUM_51kahdeksandekiljoonaa	kahdeksandekiljoonaa
NUM_51kahdeksanduodekiljardia	kahdeksanduodekiljardia
NUM_51kahdeksanduodekiljoonaa	kahdeksanduodekiljoonaa
NUM_51kahdeksankahdeksatta	kahdeksankahdeksatta
NUM_51kahdeksankiljardia	kahdeksankiljardia
NUM_51kahdeksankiljoonaa	kahdeksankiljoonaa
NUM_51kahdeksankolmatta	kahdeksankolmatta
NUM_51kahdeksankuudetta	kahdeksankuudetta
NUM_51kahdeksankvadriljardia	kahdeksankvadriljardia
NUM_51kahdeksankvadriljoonaa	kahdeksankvadriljoonaa
NUM_51kahdeksankvintiljardia	kahdeksankvintiljardia
NUM_51kahdeksankvintiljoonaa	kahdeksankvintiljoonaa
NUM_51kahdeksankymmentä	kahdeksankymmentä
NUM_51kahdeksanmiljardia	kahdeksanmiljardia
NUM_51kahdeksanmiljoonaa	kahdeksanmiljoonaa
NUM_51kahdeksanneljättä	kahdeksanneljättä
NUM_51kahdeksannoniljardia	kahdeksannoniljardia
NUM_51kahdeksannoniljoonaa	kahdeksannoniljoonaa
NUM_51kahdeksanoktiljardia	kahdeksanoktiljardia
NUM_51kahdeksanoktiljoonaa	kahdeksanoktiljoonaa
NUM_51kahdeksanpiljardia	kahdeksanpiljardia
NUM_51kahdeksanpiljoonaa	kahdeksanpiljoonaa
NUM_51kahdeksansataa	kahdeksansataa
NUM_51kahdeksanseitsemättä	kahdeksanseitsemättä
NUM_51kahdeksansentiljardia	kahdeksansentiljardia
NUM_51kahdeksansentiljoonaa	kahdeksansentiljoonaa
NUM_51kahdeksanseptiljardia	kahdeksanseptiljardia
NUM_51kahdeksanseptiljoonaa	kahdeksanseptiljoonaa
NUM_51kahdeksantoista	kahdeksantoista
NUM_51kahdeksantredekiljardia	kahdeksantredekiljardia
NUM_51kahdeksantredekiljoonaa	kahdeksantredekiljoonaa
NUM_51kahdeksantriljardia	kahdeksantriljardia
NUM_51kahdeksantriljoonaa	kahdeksantriljoonaa
NUM_51kahdeksantsiljardia	kahdeksantsiljardia
NUM_51kahdeksantsiljoonaa	kahdeksantsiljoonaa
NUM_51kahdeksantuhatta	kahdeksantuhatta
NUM_51kahdeksanundekiljardia	kahdeksanundekiljardia
NUM_51kahdeksanundekiljoonaa	kahdeksanundekiljoonaa
NUM_51kahdeksanviidettä	kahdeksanviidettä
NUM_51kahdeksanyhdeksättä	kahdeksanyhdeksättä
NUM_51kahdeksasbiljardis	kahdeksasbiljardis
NUM_51kahdeksasbiljoonas	kahdeksasbiljoonas
NUM_51kahdeksasdekiljardis	kahdeksasdekiljardis
NUM_51kahdeksasdekiljoonas	kahdeksasdekiljoonas
NUM_51kahdeksasduodekiljardis	kahdeksasduodekiljardis
NUM_51kahdeksasduodekiljoonas	kahdeksasduodekiljoonas
NUM_51kahdeksaskahdeksatta	kahdeksaskahdeksatta
NUM_51kahdeksaskiljardis	kahdeksaskiljardis
NUM_51kahdeksaskiljoonas	kahdeksaskiljoonas
NUM_51kahdeksaskolmatta	kahdeksaskolmatta
NUM_51kahdeksaskuudetta	kahdeksaskuudetta
NUM_51kahdeksaskvadriljardis	kahdeksaskvadriljardis
NUM_51kahdeksaskvadriljoonas	kahdeksaskvadriljoonas
NUM_51kahdeksaskvintiljardis	kahdeksaskvintiljardis
NUM_51kahdeksaskvintiljoonas	kahdeksaskvintiljoonas
NUM_51kahdeksaskymmenes	kahdeksaskymmenes
NUM_51kahdeksasmiljardis	kahdeksasmiljardis
NUM_51kahdeksasmiljoonas	kahdeksasmiljoonas
NUM_51kahdeksasneljästtä	kahdeksasneljästtä
NUM_51kahdeksasnoniljardis	kahdeksasnoniljardis
NUM_51kahdeksasnoniljoonas	kahdeksasnoniljoonas
NUM_51kahdeksasoktiljardis	kahdeksasoktiljardis
NUM_51kahdeksasoktiljoonas	kahdeksasoktiljoonas
NUM_51kahdeksaspiljardis	kahdeksaspiljardis
NUM_51kahdeksaspiljoonas	kahdeksaspiljoonas
NUM_51kahdeksassadas	kahdeksassadas
NUM_51kahdeksasseitsemättä	kahdeksasseitsemättä
NUM_51kahdeksassentiljardis	kahdeksassentiljardis
NUM_51kahdeksassentiljoonas	kahdeksassentiljoonas
NUM_51kahdeksasseptiljardis	kahdeksasseptiljardis
NUM_51kahdeksasseptiljoonas	kahdeksasseptiljoonas
NUM_51kahdeksastoista	kahdeksastoista
NUM_51kahdeksastredekiljardis	kahdeksastredekiljardis
NUM_51kahdeksastredekiljoonas	kahdeksastredekiljoonas
NUM_51kahdeksastriljardis	kahdeksastriljardis
NUM_51kahdeksastriljoonas	kahdeksastriljoonas
NUM_51kahdeksastsiljardis	kahdeksastsiljardis
NUM_51kahdeksastsiljoonas	kahdeksastsiljoonas
NUM_51kahdeksastuhannes	kahdeksastuhannes
NUM_51kahdeksasundekiljardis	kahdeksasundekiljardis
NUM_51kahdeksasundekiljoonas	kahdeksasundekiljoonas
NUM_51kahdeksasviidettä	kahdeksasviidettä
NUM_51kahdeksasyhdeksättä	kahdeksasyhdeksättä
NUM_51kahdesbiljardis	kahdesbiljardis
NUM_51kahdesbiljoonas	kahdesbiljoonas
NUM_51kahdesdekiljardis	kahdesdekiljardis
NUM_51kahdesdekiljoonas	kahdesdekiljoonas
NUM_51kahdesduodekiljardis	kahdesduodekiljardis
NUM_51kahdesduodekiljoonas	kahdesduodekiljoonas
NUM_51kahdeskahdeksatta	kahdeskahdeksatta
NUM_51kahdeskiljardis	kahdeskiljardis
NUM_51kahdeskiljoonas	kahdeskiljoonas
NUM_51kahdeskolmatta	kahdeskolmatta
NUM_51kahdeskuudetta	kahdeskuudetta
NUM_51kahdeskvadriljardis	kahdeskvadriljardis
NUM_51kahdeskvadriljoonas	kahdeskvadriljoonas
NUM_51kahdeskvintiljardis	kahdeskvintiljardis
NUM_51kahdeskvintiljoonas	kahdeskvintiljoonas
NUM_51kahdeskymmenes	kahdeskymmenes
NUM_51kahdesmiljardis	kahdesmiljardis
NUM_51kahdesmiljoonas	kahdesmiljoonas
NUM_51kahdesneljästtä	kahdesneljästtä
NUM_51kahdesnoniljardis	kahdesnoniljardis
NUM_51kahdesnoniljoonas	kahdesnoniljoonas
NUM_51kahdesoktiljardis	kahdesoktiljardis
NUM_51kahdesoktiljoonas	kahdesoktiljoonas
NUM_51kahdespiljardis	kahdespiljardis
NUM_51kahdespiljoonas	kahdespiljoonas
NUM_51kahdessadas	kahdessadas
NUM_51kahdesseitsemättä	kahdesseitsemättä
NUM_51kahdessentiljardis	kahdessentiljardis
NUM_51kahdessentiljoonas	kahdessentiljoonas
NUM_51kahdesseptiljardis	kahdesseptiljardis
NUM_51kahdesseptiljoonas	kahdesseptiljoonas
NUM_51kahdestoista	kahdestoista
NUM_51kahdestredekiljardis	kahdestredekiljardis
NUM_51kahdestredekiljoonas	kahdestredekiljoonas
NUM_51kahdestriljardis	kahdestriljardis
NUM_51kahdestriljoonas	kahdestriljoonas
NUM_51kahdestsiljardis	kahdestsiljardis
NUM_51kahdestsiljoonas	kahdestsiljoonas
NUM_51kahdestuhannes	kahdestuhannes
NUM_51kahdesundekiljardis	kahdesundekiljardis
NUM_51kahdesundekiljoonas	kahdesundekiljoonas
NUM_51kahdesviidettä	kahdesviidettä
NUM_51kahdesyhdeksättä	kahdesyhdeksättä
NUM_51kaksibiljardia	kaksibiljardia
NUM_51kaksibiljoonaa	kaksibiljoonaa
NUM_51kaksidekiljardia	kaksidekiljardia
NUM_51kaksidekiljoonaa	kaksidekiljoonaa
NUM_51kaksiduodekiljardia	kaksiduodekiljardia
NUM_51kaksiduodekiljoonaa	kaksiduodekiljoonaa
NUM_51kaksikahdeksatta	kaksikahdeksatta
NUM_51kaksikiljardia	kaksikiljardia
NUM_51kaksikiljoonaa	kaksikiljoonaa
NUM_51kaksikolmatta	kaksikolmatta
NUM_51kaksikuudetta	kaksikuudetta
NUM_51kaksikvadriljardia	kaksikvadriljardia
NUM_51kaksikvadriljoonaa	kaksikvadriljoonaa
NUM_51kaksikvintiljardia	kaksikvintiljardia
NUM_51kaksikvintiljoonaa	kaksikvintiljoonaa
NUM_51kaksikymmentä	kaksikymmentä
NUM_51kaksimiljardia	kaksimiljardia
NUM_51kaksimiljoonaa	kaksimiljoonaa
NUM_51kaksineljättä	kaksineljättä
NUM_51kaksinoniljardia	kaksinoniljardia
NUM_51kaksinoniljoonaa	kaksinoniljoonaa
NUM_51kaksioktiljardia	kaksioktiljardia
NUM_51kaksioktiljoonaa	kaksioktiljoonaa
NUM_51kaksipiljardia	kaksipiljardia
NUM_51kaksipiljoonaa	kaksipiljoonaa
NUM_51kaksisataa	kaksisataa
NUM_51kaksiseitsemättä	kaksiseitsemättä
NUM_51kaksisentiljardia	kaksisentiljardia
NUM_51kaksisentiljoonaa	kaksisentiljoonaa
NUM_51kaksiseptiljardia	kaksiseptiljardia
NUM_51kaksiseptiljoonaa	kaksiseptiljoonaa
NUM_51kaksitoista	kaksitoista
NUM_51kaksitredekiljardia	kaksitredekiljardia
NUM_51kaksitredekiljoonaa	kaksitredekiljoonaa
NUM_51kaksitriljardia	kaksitriljardia
NUM_51kaksitriljoonaa	kaksitriljoonaa
NUM_51kaksitsiljardia	kaksitsiljardia
NUM_51kaksitsiljoonaa	kaksitsiljoonaa
NUM_51kaksituhatta	kaksituhatta
NUM_51kaksiundekiljardia	kaksiundekiljardia
NUM_51kaksiundekiljoonaa	kaksiundekiljoonaa
NUM_51kaksiviidettä	kaksiviidettä
NUM_51kaksiyhdeksättä	kaksiyhdeksättä
NUM_51kolmasbiljardis	kolmasbiljardis
NUM_51kolmasbiljoonas	kolmasbiljoonas
NUM_51kolmasdekiljardis	kolmasdekiljardis
NUM_51kolmasdekiljoonas	kolmasdekiljoonas
NUM_51kolmasduodekiljardis	kolmasduodekiljardis
NUM_51kolmasduodekiljoonas	kolmasduodekiljoonas
NUM_51kolmaskahdeksatta	kolmaskahdeksatta
NUM_51kolmaskiljardis	kolmaskiljardis
NUM_51kolmaskiljoonas	kolmaskiljoonas
NUM_51kolmaskolmatta	kolmaskolmatta
NUM_51kolmaskuudetta	kolmaskuudetta
NUM_51kolmaskvadriljardis	kolmaskvadriljardis
NUM_51kolmaskvadriljoonas	kolmaskvadriljoonas
NUM_51kolmaskvintiljardis	kolmaskvintiljardis
NUM_51kolmaskvintiljoonas	kolmaskvintiljoonas
NUM_51kolmaskymmenes	kolmaskymmenes
NUM_51kolmasmiljardis	kolmasmiljardis
NUM_51kolmasmiljoonas	kolmasmiljoonas
NUM_51kolmasneljättä	kolmasneljättä
NUM_51kolmasnoniljardis	kolmasnoniljardis
NUM_51kolmasnoniljoonas	kolmasnoniljoonas
NUM_51kolmasoktiljardis	kolmasoktiljardis
NUM_51kolmasoktiljoonas	kolmasoktiljoonas
NUM_51kolmaspiljardis	kolmaspiljardis
NUM_51kolmaspiljoonas	kolmaspiljoonas
NUM_51kolmassadas	kolmassadas
NUM_51kolmasseitsemättä	kolmasseitsemättä
NUM_51kolmassentiljardis	kolmassentiljardis
NUM_51kolmassentiljoonas	kolmassentiljoonas
NUM_51kolmasseptiljardis	kolmasseptiljardis
NUM_51kolmasseptiljoonas	kolmasseptiljoonas
NUM_51kolmastoista	kolmastoista
NUM_51kolmastredekiljardis	kolmastredekiljardis
NUM_51kolmastredekiljoonas	kolmastredekiljoonas
NUM_51kolmastriljardis	kolmastriljardis
NUM_51kolmastriljoonas	kolmastriljoonas
NUM_51kolmastsiljardis	kolmastsiljardis
NUM_51kolmastsiljoonas	kolmastsiljoonas
NUM_51kolmastuhannes	kolmastuhannes
NUM_51kolmasundekiljardis	kolmasundekiljardis
NUM_51kolmasundekiljoonas	kolmasundekiljoonas
NUM_51kolmasviidettä	kolmasviidettä
NUM_51kolmasyhdeksättä	kolmasyhdeksättä
NUM_51kolmebiljardia	kolmebiljardia
NUM_51kolmebiljoonaa	kolmebiljoonaa
NUM_51kolmedekiljardia	kolmedekiljardia
NUM_51kolmedekiljoonaa	kolmedekiljoonaa
NUM_51kolmeduodekiljardia	kolmeduodekiljardia
NUM_51kolmeduodekiljoonaa	kolmeduodekiljoonaa
NUM_51kolmekahdeksatta	kolmekahdeksatta
NUM_51kolmekiljardia	kolmekiljardia
NUM_51kolmekiljoonaa	kolmekiljoonaa
NUM_51kolmekolmatta	kolmekolmatta
NUM_51kolmekuudetta	kolmekuudetta
NUM_51kolmekvadriljardia	kolmekvadriljardia
NUM_51kolmekvadriljoonaa	kolmekvadriljoonaa
NUM_51kolmekvintiljardia	kolmekvintiljardia
NUM_51kolmekvintiljoonaa	kolmekvintiljoonaa
NUM_51kolmekymmentä	kolmekymmentä
NUM_51kolmemiljardia	kolmemiljardia
NUM_51kolmemiljoonaa	kolmemiljoonaa
NUM_51kolmeneljättä	kolmeneljättä
NUM_51kolmenoniljardia	kolmenoniljardia
NUM_51kolmenoniljoonaa	kolmenoniljoonaa
NUM_51kolmeoktiljardia	kolmeoktiljardia
NUM_51kolmeoktiljoonaa	kolmeoktiljoonaa
NUM_51kolmepiljardia	kolmepiljardia
NUM_51kolmepiljoonaa	kolmepiljoonaa
NUM_51kolmesataa	kolmesataa
NUM_51kolmeseitsemättä	kolmeseitsemättä
NUM_51kolmesentiljardia	kolmesentiljardia
NUM_51kolmesentiljoonaa	kolmesentiljoonaa
NUM_51kolmeseptiljardia	kolmeseptiljardia
NUM_51kolmeseptiljoonaa	kolmeseptiljoonaa
NUM_51kolmetoista	kolmetoista
NUM_51kolmetredekiljardia	kolmetredekiljardia
NUM_51kolmetredekiljoonaa	kolmetredekiljoonaa
NUM_51kolmetriljardia	kolmetriljardia
NUM_51kolmetriljoonaa	kolmetriljoonaa
NUM_51kolmetsiljardia	kolmetsiljardia
NUM_51kolmetsiljoonaa	kolmetsiljoonaa
NUM_51kolmetuhatta	kolmetuhatta
NUM_51kolmeundekiljardia	kolmeundekiljardia
NUM_51kolmeundekiljoonaa	kolmeundekiljoonaa
NUM_51kolmeviidettä	kolmeviidettä
NUM_51kolmeyhdeksättä	kolmeyhdeksättä
NUM_51kuudesbiljardis	kuudesbiljardis
NUM_51kuudesbiljoonas	kuudesbiljoonas
NUM_51kuudesdekiljardis	kuudesdekiljardis
NUM_51kuudesdekiljoonas	kuudesdekiljoonas
NUM_51kuudesduodekiljardis	kuudesduodekiljardis
NUM_51kuudesduodekiljoonas	kuudesduodekiljoonas
NUM_51kuudeskahdeksatta	kuudeskahdeksatta
NUM_51kuudeskiljardis	kuudeskiljardis
NUM_51kuudeskiljoonas	kuudeskiljoonas
NUM_51kuudeskolmatta	kuudeskolmatta
NUM_51kuudeskuudetta	kuudeskuudetta
NUM_51kuudeskvadriljardis	kuudeskvadriljardis
NUM_51kuudeskvadriljoonas	kuudeskvadriljoonas
NUM_51kuudeskvintiljardis	kuudeskvintiljardis
NUM_51kuudeskvintiljoonas	kuudeskvintiljoonas
NUM_51kuudeskymmenes	kuudeskymmenes
NUM_51kuudesmiljardis	kuudesmiljardis
NUM_51kuudesmiljoonas	kuudesmiljoonas
NUM_51kuudesneljästtä	kuudesneljästtä
NUM_51kuudesnoniljardis	kuudesnoniljardis
NUM_51kuudesnoniljoonas	kuudesnoniljoonas
NUM_51kuudesoktiljardis	kuudesoktiljardis
NUM_51kuudesoktiljoonas	kuudesoktiljoonas
NUM_51kuudespiljardis	kuudespiljardis
NUM_51kuudespiljoonas	kuudespiljoonas
NUM_51kuudessadas	kuudessadas
NUM_51kuudesseitsemättä	kuudesseitsemättä
NUM_51kuudessentiljardis	kuudessentiljardis
NUM_51kuudessentiljoonas	kuudessentiljoonas
NUM_51kuudesseptiljardis	kuudesseptiljardis
NUM_51kuudesseptiljoonas	kuudesseptiljoonas
NUM_51kuudestoista	kuudestoista
NUM_51kuudestredekiljardis	kuudestredekiljardis
NUM_51kuudestredekiljoonas	kuudestredekiljoonas
NUM_51kuudestriljardis	kuudestriljardis
NUM_51kuudestriljoonas	kuudestriljoonas
NUM_51kuudestsiljardis	kuudestsiljardis
NUM_51kuudestsiljoonas	kuudestsiljoonas
NUM_51kuudestuhannes	kuudestuhannes
NUM_51kuudesundekiljardis	kuudesundekiljardis
NUM_51kuudesundekiljoonas	kuudesundekiljoonas
NUM_51kuudesviidettä	kuudesviidettä
NUM_51kuudesyhdeksättä	kuudesyhdeksättä
NUM_51kuusibiljardia	kuusibiljardia
NUM_51kuusibiljoonaa	kuusibiljoonaa
NUM_51kuusidekiljardia	kuusidekiljardia
NUM_51kuusidekiljoonaa	kuusidekiljoonaa
NUM_51kuusiduodekiljardia	kuusiduodekiljardia
NUM_51kuusiduodekiljoonaa	kuusiduodekiljoonaa
NUM_51kuusikahdeksatta	kuusikahdeksatta
NUM_51kuusikiljardia	kuusikiljardia
NUM_51kuusikiljoonaa	kuusikiljoonaa
NUM_51kuusikolmatta	kuusikolmatta
NUM_51kuusikuudetta	kuusikuudetta
NUM_51kuusikvadriljardia	kuusikvadriljardia
NUM_51kuusikvadriljoonaa	kuusikvadriljoonaa
NUM_51kuusikvintiljardia	kuusikvintiljardia
NUM_51kuusikvintiljoonaa	kuusikvintiljoonaa
NUM_51kuusikymmentä	kuusikymmentä
NUM_51kuusimiljardia	kuusimiljardia
NUM_51kuusimiljoonaa	kuusimiljoonaa
NUM_51kuusineljättä	kuusineljättä
NUM_51kuusinoniljardia	kuusinoniljardia
NUM_51kuusinoniljoonaa	kuusinoniljoonaa
NUM_51kuusioktiljardia	kuusioktiljardia
NUM_51kuusioktiljoonaa	kuusioktiljoonaa
NUM_51kuusipiljardia	kuusipiljardia
NUM_51kuusipiljoonaa	kuusipiljoonaa
NUM_51kuusisataa	kuusisataa
NUM_51kuusiseitsemättä	kuusiseitsemättä
NUM_51kuusisentiljardia	kuusisentiljardia
NUM_51kuusisentiljoonaa	kuusisentiljoonaa
NUM_51kuusiseptiljardia	kuusiseptiljardia
NUM_51kuusiseptiljoonaa	kuusiseptiljoonaa
NUM_51kuusitoista	kuusitoista
NUM_51kuusitredekiljardia	kuusitredekiljardia
NUM_51kuusitredekiljoonaa	kuusitredekiljoonaa
NUM_51kuusitriljardia	kuusitriljardia
NUM_51kuusitriljoonaa	kuusitriljoonaa
NUM_51kuusitsiljardia	kuusitsiljardia
NUM_51kuusitsiljoonaa	kuusitsiljoonaa
NUM_51kuusituhatta	kuusituhatta
NUM_51kuusiundekiljardia	kuusiundekiljardia
NUM_51kuusiundekiljoonaa	kuusiundekiljoonaa
NUM_51kuusiviidettä	kuusiviidettä
NUM_51kuusiyhdeksättä	kuusiyhdeksättä
NUM_51neljäbiljardia	neljäbiljardia
NUM_51neljäbiljoonaa	neljäbiljoonaa
NUM_51neljädekiljardia	neljädekiljardia
NUM_51neljädekiljoonaa	neljädekiljoonaa
NUM_51neljäduodekiljardia	neljäduodekiljardia
NUM_51neljäduodekiljoonaa	neljäduodekiljoonaa
NUM_51neljäkahdeksatta	neljäkahdeksatta
NUM_51neljäkiljardia	neljäkiljardia
NUM_51neljäkiljoonaa	neljäkiljoonaa
NUM_51neljäkolmatta	neljäkolmatta
NUM_51neljäkuudetta	neljäkuudetta
NUM_51neljäkvadriljardia	neljäkvadriljardia
NUM_51neljäkvadriljoonaa	neljäkvadriljoonaa
NUM_51neljäkvintiljardia	neljäkvintiljardia
NUM_51neljäkvintiljoonaa	neljäkvintiljoonaa
NUM_51neljäkymmentä	neljäkymmentä
NUM_51neljämiljardia	neljämiljardia
NUM_51neljämiljoonaa	neljämiljoonaa
NUM_51neljäneljättä	neljäneljättä
NUM_51neljänoniljardia	neljänoniljardia
NUM_51neljänoniljoonaa	neljänoniljoonaa
NUM_51neljäoktiljardia	neljäoktiljardia
NUM_51neljäoktiljoonaa	neljäoktiljoonaa
NUM_51neljäpiljardia	neljäpiljardia
NUM_51neljäpiljoonaa	neljäpiljoonaa
NUM_51neljäsataa	neljäsataa
NUM_51neljäsbiljardis	neljäsbiljardis
NUM_51neljäsbiljoonas	neljäsbiljoonas
NUM_51neljäsdekiljardis	neljäsdekiljardis
NUM_51neljäsdekiljoonas	neljäsdekiljoonas
NUM_51neljäsduodekiljardis	neljäsduodekiljardis
NUM_51neljäsduodekiljoonas	neljäsduodekiljoonas
NUM_51neljäseitsemättä	neljäseitsemättä
NUM_51neljäsentiljardia	neljäsentiljardia
NUM_51neljäsentiljoonaa	neljäsentiljoonaa
NUM_51neljäseptiljardia	neljäseptiljardia
NUM_51neljäseptiljoonaa	neljäseptiljoonaa
NUM_51neljäskahdeksatta	neljäskahdeksatta
NUM_51neljäskiljardis	neljäskiljardis
NUM_51neljäskiljoonas	neljäskiljoonas
NUM_51neljäskolmatta	neljäskolmatta
NUM_51neljäskuudetta	neljäskuudetta
NUM_51neljäskvadriljardis	neljäskvadriljardis
NUM_51neljäskvadriljoonas	neljäskvadriljoonas
NUM_51neljäskvintiljardis	neljäskvintiljardis
NUM_51neljäskvintiljoonas	neljäskvintiljoonas
NUM_51neljäskymmenes	neljäskymmenes
NUM_51neljäsmiljardis	neljäsmiljardis
NUM_51neljäsmiljoonas	neljäsmiljoonas
NUM_51neljäsneljättä	neljäsneljättä
NUM_51neljäsnoniljardis	neljäsnoniljardis
NUM_51neljäsnoniljoonas	neljäsnoniljoonas
NUM_51neljäsoktiljardis	neljäsoktiljardis
NUM_51neljäsoktiljoonas	neljäsoktiljoonas
NUM_51neljäspiljardis	neljäspiljardis
NUM_51neljäspiljoonas	neljäspiljoonas
NUM_51neljässadas	neljässadas
NUM_51neljässeitsemättä	neljässeitsemättä
NUM_51neljässentiljardis	neljässentiljardis
NUM_51neljässentiljoonas	neljässentiljoonas
NUM_51neljässeptiljardis	neljässeptiljardis
NUM_51neljässeptiljoonas	neljässeptiljoonas
NUM_51neljästoista	neljästoista
NUM_51neljästredekiljardis	neljästredekiljardis
NUM_51neljästredekiljoonas	neljästredekiljoonas
NUM_51neljästriljardis	neljästriljardis
NUM_51neljästriljoonas	neljästriljoonas
NUM_51neljästsiljardis	neljästsiljardis
NUM_51neljästsiljoonas	neljästsiljoonas
NUM_51neljästuhannes	neljästuhannes
NUM_51neljäsundekiljardis	neljäsundekiljardis
NUM_51neljäsundekiljoonas	neljäsundekiljoonas
NUM_51neljäsviidettä	neljäsviidettä
NUM_51neljäsyhdeksättä	neljäsyhdeksättä
NUM_51neljätoista	neljätoista
NUM_51neljätredekiljardia	neljätredekiljardia
NUM_51neljätredekiljoonaa	neljätredekiljoonaa
NUM_51neljätriljardia	neljätriljardia
NUM_51neljätriljoonaa	neljätriljoonaa
NUM_51neljätsiljardia	neljätsiljardia
NUM_51neljätsiljoonaa	neljätsiljoonaa
NUM_51neljätuhatta	neljätuhatta
NUM_51neljäundekiljardia	neljäundekiljardia
NUM_51neljäundekiljoonaa	neljäundekiljoonaa
NUM_51neljäviidettä	neljäviidettä
NUM_51neljäyhdeksättä	neljäyhdeksättä
NUM_51puolitoista	puolitoista
NUM_51seitsemänbiljardia	seitsemänbiljardia
NUM_51seitsemänbiljoonaa	seitsemänbiljoonaa
NUM_51seitsemändekiljardia	seitsemändekiljardia
NUM_51seitsemändekiljoonaa	seitsemändekiljoonaa
NUM_51seitsemänduodekiljardia	seitsemänduodekiljardia
NUM_51seitsemänduodekiljoonaa	seitsemänduodekiljoonaa
NUM_51seitsemänkahdeksatta	seitsemänkahdeksatta
NUM_51seitsemänkiljardia	seitsemänkiljardia
NUM_51seitsemänkiljoonaa	seitsemänkiljoonaa
NUM_51seitsemänkolmatta	seitsemänkolmatta
NUM_51seitsemänkuudetta	seitsemänkuudetta
NUM_51seitsemänkvadriljardia	seitsemänkvadriljardia
NUM_51seitsemänkvadriljoonaa	seitsemänkvadriljoonaa
NUM_51seitsemänkvintiljardia	seitsemänkvintiljardia
NUM_51seitsemänkvintiljoonaa	seitsemänkvintiljoonaa
NUM_51seitsemänkymmentä	seitsemänkymmentä
NUM_51seitsemänmiljardia	seitsemänmiljardia
NUM_51seitsemänmiljoonaa	seitsemänmiljoonaa
NUM_51seitsemänneljättä	seitsemänneljättä
NUM_51seitsemännoniljardia	seitsemännoniljardia
NUM_51seitsemännoniljoonaa	seitsemännoniljoonaa
NUM_51seitsemänoktiljardia	seitsemänoktiljardia
NUM_51seitsemänoktiljoonaa	seitsemänoktiljoonaa
NUM_51seitsemänpiljardia	seitsemänpiljardia
NUM_51seitsemänpiljoonaa	seitsemänpiljoonaa
NUM_51seitsemänsataa	seitsemänsataa
NUM_51seitsemänseitsemättä	seitsemänseitsemättä
NUM_51seitsemänsentiljardia	seitsemänsentiljardia
NUM_51seitsemänsentiljoonaa	seitsemänsentiljoonaa
NUM_51seitsemänseptiljardia	seitsemänseptiljardia
NUM_51seitsemänseptiljoonaa	seitsemänseptiljoonaa
NUM_51seitsemäntoista	seitsemäntoista
NUM_51seitsemäntredekiljardia	seitsemäntredekiljardia
NUM_51seitsemäntredekiljoonaa	seitsemäntredekiljoonaa
NUM_51seitsemäntriljardia	seitsemäntriljardia
NUM_51seitsemäntriljoonaa	seitsemäntriljoonaa
NUM_51seitsemäntsiljardia	seitsemäntsiljardia
NUM_51seitsemäntsiljoonaa	seitsemäntsiljoonaa
NUM_51seitsemäntuhatta	seitsemäntuhatta
NUM_51seitsemänundekiljardia	seitsemänundekiljardia
NUM_51seitsemänundekiljoonaa	seitsemänundekiljoonaa
NUM_51seitsemänviidettä	seitsemänviidettä
NUM_51seitsemänyhdeksättä	seitsemänyhdeksättä
NUM_51seitsemäsbiljardis	seitsemäsbiljardis
NUM_51seitsemäsbiljoonas	seitsemäsbiljoonas
NUM_51seitsemäsdekiljardis	seitsemäsdekiljardis
NUM_51seitsemäsdekiljoonas	seitsemäsdekiljoonas
NUM_51seitsemäsduodekiljardis	seitsemäsduodekiljardis
NUM_51seitsemäsduodekiljoonas	seitsemäsduodekiljoonas
NUM_51seitsemäskahdeksatta	seitsemäskahdeksatta
NUM_51seitsemäskiljardis	seitsemäskiljardis
NUM_51seitsemäskiljoonas	seitsemäskiljoonas
NUM_51seitsemäskolmatta	seitsemäskolmatta
NUM_51seitsemäskuudetta	seitsemäskuudetta
NUM_51seitsemäskvadriljardis	seitsemäskvadriljardis
NUM_51seitsemäskvadriljoonas	seitsemäskvadriljoonas
NUM_51seitsemäskvintiljardis	seitsemäskvintiljardis
NUM_51seitsemäskvintiljoonas	seitsemäskvintiljoonas
NUM_51seitsemäskymmenes	seitsemäskymmenes
NUM_51seitsemäsmiljardis	seitsemäsmiljardis
NUM_51seitsemäsmiljoonas	seitsemäsmiljoonas
NUM_51seitsemäsneljästtä	seitsemäsneljästtä
NUM_51seitsemäsnoniljardis	seitsemäsnoniljardis
NUM_51seitsemäsnoniljoonas	seitsemäsnoniljoonas
NUM_51seitsemäsoktiljardis	seitsemäsoktiljardis
NUM_51seitsemäsoktiljoonas	seitsemäsoktiljoonas
NUM_51seitsemäspiljardis	seitsemäspiljardis
NUM_51seitsemäspiljoonas	seitsemäspiljoonas
NUM_51seitsemässadas	seitsemässadas
NUM_51seitsemässeitsemättä	seitsemässeitsemättä
NUM_51seitsemässentiljardis	seitsemässentiljardis
NUM_51seitsemässentiljoonas	seitsemässentiljoonas
NUM_51seitsemässeptiljardis	seitsemässeptiljardis
NUM_51seitsemässeptiljoonas	seitsemässeptiljoonas
NUM_51seitsemästoista	seitsemästoista
NUM_51seitsemästredekiljardis	seitsemästredekiljardis
NUM_51seitsemästredekiljoonas	seitsemästredekiljoonas
NUM_51seitsemästriljardis	seitsemästriljardis
NUM_51seitsemästriljoonas	seitsemästriljoonas
NUM_51seitsemästsiljardis	seitsemästsiljardis
NUM_51seitsemästsiljoonas	seitsemästsiljoonas
NUM_51seitsemästuhannes	seitsemästuhannes
NUM_51seitsemäsundekiljardis	seitsemäsundekiljardis
NUM_51seitsemäsundekiljoonas	seitsemäsundekiljoonas
NUM_51seitsemäsviidettä	seitsemäsviidettä
NUM_51seitsemäsyhdeksättä	seitsemäsyhdeksättä
NUM_51viidesbiljardis	viidesbiljardis
NUM_51viidesbiljoonas	viidesbiljoonas
NUM_51viidesdekiljardis	viidesdekiljardis
NUM_51viidesdekiljoonas	viidesdekiljoonas
NUM_51viidesduodekiljardis	viidesduodekiljardis
NUM_51viidesduodekiljoonas	viidesduodekiljoonas
NUM_51viideskahdeksatta	viideskahdeksatta
NUM_51viideskiljardis	viideskiljardis
NUM_51viideskiljoonas	viideskiljoonas
NUM_51viideskolmatta	viideskolmatta
NUM_51viideskuudetta	viideskuudetta
NUM_51viideskvadriljardis	viideskvadriljardis
NUM_51viideskvadriljoonas	viideskvadriljoonas
NUM_51viideskvintiljardis	viideskvintiljardis
NUM_51viideskvintiljoonas	viideskvintiljoonas
NUM_51viideskymmenes	viideskymmenes
NUM_51viidesmiljardis	viidesmiljardis
NUM_51viidesmiljoonas	viidesmiljoonas
NUM_51viidesneljästtä	viidesneljästtä
NUM_51viidesnoniljardis	viidesnoniljardis
NUM_51viidesnoniljoonas	viidesnoniljoonas
NUM_51viidesoktiljardis	viidesoktiljardis
NUM_51viidesoktiljoonas	viidesoktiljoonas
NUM_51viidespiljardis	viidespiljardis
NUM_51viidespiljoonas	viidespiljoonas
NUM_51viidessadas	viidessadas
NUM_51viidesseitsemättä	viidesseitsemättä
NUM_51viidessentiljardis	viidessentiljardis
NUM_51viidessentiljoonas	viidessentiljoonas
NUM_51viidesseptiljardis	viidesseptiljardis
NUM_51viidesseptiljoonas	viidesseptiljoonas
NUM_51viidestoista	viidestoista
NUM_51viidestredekiljardis	viidestredekiljardis
NUM_51viidestredekiljoonas	viidestredekiljoonas
NUM_51viidestriljardis	viidestriljardis
NUM_51viidestriljoonas	viidestriljoonas
NUM_51viidestsiljardis	viidestsiljardis
NUM_51viidestsiljoonas	viidestsiljoonas
NUM_51viidestuhannes	viidestuhannes
NUM_51viidesundekiljardis	viidesundekiljardis
NUM_51viidesundekiljoonas	viidesundekiljoonas
NUM_51viidesviidettä	viidesviidettä
NUM_51viidesyhdeksättä	viidesyhdeksättä
NUM_51viisibiljardia	viisibiljardia
NUM_51viisibiljoonaa	viisibiljoonaa
NUM_51viisidekiljardia	viisidekiljardia
NUM_51viisidekiljoonaa	viisidekiljoonaa
NUM_51viisiduodekiljardia	viisiduodekiljardia
NUM_51viisiduodekiljoonaa	viisiduodekiljoonaa
NUM_51viisikahdeksatta	viisikahdeksatta
NUM_51viisikiljardia	viisikiljardia
NUM_51viisikiljoonaa	viisikiljoonaa
NUM_51viisikolmatta	viisikolmatta
NUM_51viisikuudetta	viisikuudetta
NUM_51viisikvadriljardia	viisikvadriljardia
NUM_51viisikvadriljoonaa	viisikvadriljoonaa
NUM_51viisikvintiljardia	viisikvintiljardia
NUM_51viisikvintiljoonaa	viisikvintiljoonaa
NUM_51viisikymmentä	viisikymmentä
NUM_51viisimiljardia	viisimiljardia
NUM_51viisimiljoonaa	viisimiljoonaa
NUM_51viisineljättä	viisineljättä
NUM_51viisinoniljardia	viisinoniljardia
NUM_51viisinoniljoonaa	viisinoniljoonaa
NUM_51viisioktiljardia	viisioktiljardia
NUM_51viisioktiljoonaa	viisioktiljoonaa
NUM_51viisipiljardia	viisipiljardia
NUM_51viisipiljoonaa	viisipiljoonaa
NUM_51viisisataa	viisisataa
NUM_51viisiseitsemättä	viisiseitsemättä
NUM_51viisisentiljardia	viisisentiljardia
NUM_51viisisentiljoonaa	viisisentiljoonaa
NUM_51viisiseptiljardia	viisiseptiljardia
NUM_51viisiseptiljoonaa	viisiseptiljoonaa
NUM_51viisitoista	viisitoista
NUM_51viisitredekiljardia	viisitredekiljardia
NUM_51viisitredekiljoonaa	viisitredekiljoonaa
NUM_51viisitriljardia	viisitriljardia
NUM_51viisitriljoonaa	viisitriljoonaa
NUM_51viisitsiljardia	viisitsiljardia
NUM_51viisitsiljoonaa	viisitsiljoonaa
NUM_51viisituhatta	viisituhatta
NUM_51viisiundekiljardia	viisiundekiljardia
NUM_51viisiundekiljoonaa	viisiundekiljoonaa
NUM_51viisiviidettä	viisiviidettä
NUM_51viisiyhdeksättä	viisiyhdeksättä
NUM_51yhdeksänbiljardia	yhdeksänbiljardia
NUM_51yhdeksänbiljoonaa	yhdeksänbiljoonaa
NUM_51yhdeksändekiljardia	yhdeksändekiljardia
NUM_51yhdeksändekiljoonaa	yhdeksändekiljoonaa
NUM_51yhdeksänduodekiljardia	yhdeksänduodekiljardia
NUM_51yhdeksänduodekiljoonaa	yhdeksänduodekiljoonaa
NUM_51yhdeksänkahdeksatta	yhdeksänkahdeksatta
NUM_51yhdeksänkiljardia	yhdeksänkiljardia
NUM_51yhdeksänkiljoonaa	yhdeksänkiljoonaa
NUM_51yhdeksänkolmatta	yhdeksänkolmatta
NUM_51yhdeksänkuudetta	yhdeksänkuudetta
NUM_51yhdeksänkvadriljardia	yhdeksänkvadriljardia
NUM_51yhdeksänkvadriljoonaa	yhdeksänkvadriljoonaa
NUM_51yhdeksänkvintiljardia	yhdeksänkvintiljardia
NUM_51yhdeksänkvintiljoonaa	yhdeksänkvintiljoonaa
NUM_51yhdeksänkymmentä	yhdeksänkymmentä
NUM_51yhdeksänmiljardia	yhdeksänmiljardia
NUM_51yhdeksänmiljoonaa	yhdeksänmiljoonaa
NUM_51yhdeksänneljättä	yhdeksänneljättä
NUM_51yhdeksännoniljardia	yhdeksännoniljardia
NUM_51yhdeksännoniljoonaa	yhdeksännoniljoonaa
NUM_51yhdeksänoktiljardia	yhdeksänoktiljardia
NUM_51yhdeksänoktiljoonaa	yhdeksänoktiljoonaa
NUM_51yhdeksänpiljardia	yhdeksänpiljardia
NUM_51yhdeksänpiljoonaa	yhdeksänpiljoonaa
NUM_51yhdeksänsataa	yhdeksänsataa
NUM_51yhdeksänseitsemättä	yhdeksänseitsemättä
NUM_51yhdeksänsentiljardia	yhdeksänsentiljardia
NUM_51yhdeksänsentiljoonaa	yhdeksänsentiljoonaa
NUM_51yhdeksänseptiljardia	yhdeksänseptiljardia
NUM_51yhdeksänseptiljoonaa	yhdeksänseptiljoonaa
NUM_51yhdeksäntoista	yhdeksäntoista
NUM_51yhdeksäntredekiljardia	yhdeksäntredekiljardia
NUM_51yhdeksäntredekiljoonaa	yhdeksäntredekiljoonaa
NUM_51yhdeksäntriljardia	yhdeksäntriljardia
NUM_51yhdeksäntriljoonaa	yhdeksäntriljoonaa
NUM_51yhdeksäntsiljardia	yhdeksäntsiljardia
NUM_51yhdeksäntsiljoonaa	yhdeksäntsiljoonaa
NUM_51yhdeksäntuhatta	yhdeksäntuhatta
NUM_51yhdeksänundekiljardia	yhdeksänundekiljardia
NUM_51yhdeksänundekiljoonaa	yhdeksänundekiljoonaa
NUM_51yhdeksänviidettä	yhdeksänviidettä
NUM_51yhdeksänyhdeksättä	yhdeksänyhdeksättä
NUM_51yhdeksäsbiljardis	yhdeksäsbiljardis
NUM_51yhdeksäsbiljoonas	yhdeksäsbiljoonas
NUM_51yhdeksäsdekiljardis	yhdeksäsdekiljardis
NUM_51yhdeksäsdekiljoonas	yhdeksäsdekiljoonas
NUM_51yhdeksäsduodekiljardis	yhdeksäsduodekiljardis
NUM_51yhdeksäsduodekiljoonas	yhdeksäsduodekiljoonas
NUM_51yhdeksäskahdeksatta	yhdeksäskahdeksatta
NUM_51yhdeksäskiljardis	yhdeksäskiljardis
NUM_51yhdeksäskiljoonas	yhdeksäskiljoonas
NUM_51yhdeksäskolmatta	yhdeksäskolmatta
NUM_51yhdeksäskuudetta	yhdeksäskuudetta
NUM_51yhdeksäskvadriljardis	yhdeksäskvadriljardis
NUM_51yhdeksäskvadriljoonas	yhdeksäskvadriljoonas
NUM_51yhdeksäskvintiljardis	yhdeksäskvintiljardis
NUM_51yhdeksäskvintiljoonas	yhdeksäskvintiljoonas
NUM_51yhdeksäskymmenes	yhdeksäskymmenes
NUM_51yhdeksäsmiljardis	yhdeksäsmiljardis
NUM_51yhdeksäsmiljoonas	yhdeksäsmiljoonas
NUM_51yhdeksäsneljästtä	yhdeksäsneljästtä
NUM_51yhdeksäsnoniljardis	yhdeksäsnoniljardis
NUM_51yhdeksäsnoniljoonas	yhdeksäsnoniljoonas
NUM_51yhdeksäsoktiljardis	yhdeksäsoktiljardis
NUM_51yhdeksäsoktiljoonas	yhdeksäsoktiljoonas
NUM_51yhdeksäspiljardis	yhdeksäspiljardis
NUM_51yhdeksäspiljoonas	yhdeksäspiljoonas
NUM_51yhdeksässadas	yhdeksässadas
NUM_51yhdeksässeitsemättä	yhdeksässeitsemättä
NUM_51yhdeksässentiljardis	yhdeksässentiljardis
NUM_51yhdeksässentiljoonas	yhdeksässentiljoonas
NUM_51yhdeksässeptiljardis	yhdeksässeptiljardis
NUM_51yhdeksässeptiljoonas	yhdeksässeptiljoonas
NUM_51yhdeksästoista	yhdeksästoista
NUM_51yhdeksästredekiljardis	yhdeksästredekiljardis
NUM_51yhdeksästredekiljoonas	yhdeksästredekiljoonas
NUM_51yhdeksästriljardis	yhdeksästriljardis
NUM_51yhdeksästriljoonas	yhdeksästriljoonas
NUM_51yhdeksästsiljardis	yhdeksästsiljardis
NUM_51yhdeksästsiljoonas	yhdeksästsiljoonas
NUM_51yhdeksästuhannes	yhdeksästuhannes
NUM_51yhdeksäsundekiljardis	yhdeksäsundekiljardis
NUM_51yhdeksäsundekiljoonas	yhdeksäsundekiljoonas
NUM_51yhdeksäsviidettä	yhdeksäsviidettä
NUM_51yhdeksäsyhdeksättä	yhdeksäsyhdeksättä
NUM_51yhdeskahdeksatta	yhdeskahdeksatta
NUM_51yhdeskolmatta	yhdeskolmatta
NUM_51yhdeskuudetta	yhdeskuudetta
NUM_51yhdesneljästtä	yhdesneljästtä
NUM_51yhdesseitsemättä	yhdesseitsemättä
NUM_51yhdestoista	yhdestoista
NUM_51yhdesviidettä	yhdesviidettä
NUM_51yhdesyhdeksättä	yhdesyhdeksättä
NUM_51yksikahdeksatta	yksikahdeksatta
NUM_51yksikolmatta	yksikolmatta
NUM_51yksikuudetta	yksikuudetta
NUM_51yksineljättä	yksineljättä
NUM_51yksiseitsemättä	yksiseitsemättä
NUM_51yksitoista	yksitoista
NUM_51yksiviidettä	yksiviidettä
NUM_51yksiyhdeksättä	yksiyhdeksättä
NUM_ENSIMMÄINEN	inen
NUM_KAHDEKSAN	kahdeksan
NUM_KAKSI	kaksi
NUM_KOLMASOSA	osa
NUM_KOLMAS	s
NUM_KOLME	kolme
NUM_KUUSI	kuusi
NUM_KUUTISEN	isen
NUM_KYMMENEN	kymmenen
NUM_KYMMENKUNTA	kunta
NUM_KYMMEN	kymmen
NUM_KYMMENTÄ
NUM_MILJARDI	iljardi
NUM_MILJOONA	a
NUM_NELJÄ	neljä
NUM_NELJÄS	s
NUM_PARI	i
NUM_PUOLI	i
NUM_SATA	sata
NUM_TOINEN	inen
NUM_TUHAT	tuhat
NUM_VIISI	viisi
NUM_VIITISEN	isen
NUM_YHDEKSÄN	än
NUM_YKSI	yksi
omorfi	.
PRON_AINOA	a
PRON_ERÄS	s
PRON_HÄÄ	hää
PRON_HÄN	hän
PRON_IKINEN	nen
PRON_ITSE	itse
PRON_JOKAINEN	nen
PRON_JOKA	ka
PRON_JOKIN	kin
PRON_JOKU	joku
PRON_JOMPIKUMPI	jompikumpi
PRON_KAIKKI	kaikki
PRON_KOKO
PRON_KUKAAN	kukaan
PRON_KUKAKIN	kukakin
PRON_KUKA	kuka
PRON_KUKIN	kukin
PRON_KUMPIKAAN	mpikaan
PRON_KUMPIKIN	mpikin
PRON_KUMPI	mpi
PRON_MA	a
PRON_MÄ	ä
PRON_MÄÄ	.
PRON_ME	e
PRON_MIE	ie
PRON_MIKÄÄN	mikään
PRON_MIKÄKIN	mikäkin
PRON_MIKÄ	mikä
PRON_MIKIN	mikin
PRON_MINÄ	inä
PRON_MOLEMMAT	molemmat
PRON_MONES	mones
PRON_MONIAS	monias
PRON_MONI	moni
PRON_MONTA	monta
PRON_MUUAN	an
PRON_MUU	muu
PRON_MUUTAMA	muutama
PRON_NÄMÄ	nämä
PRON_NE	ne
PRON_NOI	noi
PRON_NUO	nuo
PRON_SAMA	a
PRON_SE	se
PRON_TÄMÄ	tämä
PRON_TOINEN	toinen
PRON_TOI	toi
PRON_TUO	tuo
PRON_USEAMPI	mpi
PRON_USEA	usea
PRON_USEIMMAT	useimmat
PRON_YKSI	yksi
PROPN_51Iso-Britannia	Iso-Britannia
PROPN_51Mustameri	Mustameri
PROPN_51Punainenmeri	Punainenmeri
PROPN_51Tyynimeri	Tyynimeri
PROPN_51Uusikaupunki	Uusikaupunki
PROPN_51Uusimaa	Uusimaa
PROPN_51Uusi-Seelanti	Uusi-Seelanti
PROPN_A.	\.
PROPN_AAKKOSELLISUUS	us
PROPN_AAKKOSTAMINEN	nen
PROPN_AALLOT	lot
PROPN_AARRE	rre
PROPN_ACRO_AA	[Aa]
PROPN_ACRO_ÄKS	[FLMNRŠSXŽflmnršsxž²³]
PROPN_ACRO_DOLLARI	.
PROPN_ACRO_EE	[BCDEGPTVWbcdegptvw]
PROPN_ACRO_GRAMMA	.
PROPN_ACRO_II	[IJij]
PROPN_ACRO_JÄRJESTÖ	.
PROPN_ACRO_KAHDEKSAN	8
PROPN_ACRO_KAKSI	2
PROPN_ACRO_KANDELA	.
PROPN_ACRO_KOLME	3
PROPN_ACRO_KUUSI	6
PROPN_ACRO_LEHTI
PROPN_ACRO_METRI	.
PROPN_ACRO_NELJÄ	4
PROPN_ACRO_NOLLA	0
PROPN_ACRO_OO	[HKOÅhkoå]
PROPN_ACRO_ÖÖ	[Öö]
PROPN_ACRO_PUNTA	.
PROPN_ACRO_SEITSEMÄN	.
PROPN_ACRO_UU	[QUqu]
PROPN_ACRO_VIISI	.
PROPN_ACRO_WEBER	.
PROPN_ACRO_YHDEKSÄN	9
PROPN_ACRO_YKSI	1
PROPN_ACRO_YY	[YÜyü]
PROPN_ACRO_ZET	[ZŽzž]
PROPN_ACRO_Ω	.
PROPN_ACRO_Ω	.
PROPN_AHDET	det
PROPN_AIVOKUOLLUT	ut
PROPN_AIVOT	ot
PROPN_AJATAR	tar
PROPN_ALKU	ku
PROPN_ALLAS	las
PROPN_ALTIS	tis
PROPN_APE	e
PROPN_APU	pu
PROPN_ARISTOTELES	es
PROPN_ARKI	ki
PROPN_ASEMA	a
PROPN_ASKAR
PROPN_ASTE	e
PROPN_ASUKAS	kas
PROPN_ASU	[Uuú]
PROPN_ATERIMET	met
PROPN_ÄYRÄS	äs
PROPN_BÉBÉ
PROPN_BEIGNET
PROPN_BERNIE	e
PROPN_BESSERWISSER
PROPN_BIDEE	ee
PROPN_BIKINIT	it
PROPN_BORDEAUX
PROPN_BRASSERIE
PROPN_BRIE	.
PROPN_CAMUS
PROPN_CHACHACHA
PROPN_COMPOUND	.
PROPN_COWBOY	.
PROPN_DIMITRIS	s
PROPN_EKKE	ke
PROPN_ELÄMÄ	ä
PROPN_ELIN	n
PROPN_EPÄILTY	lty
PROPN_ESQUIMAU
PROPN_EUGENE
PROPN_FÄNRIKIT	it
PROPN_FARKUT	ut
PROPN_FARMARIT	it
PROPN_FIFA
PROPN_FONDUE
PROPN_GAY
PROPN_HAAKSI	ksi
PROPN_HÄÄT	äät
PROPN_HÄÄTÖ	tö
PROPN_HAI	i
PROPN_HÄIRIÖ	ö
PROPN_HAIT	it
PROPN_HÄKKI	ki
PROPN_HÄKKYRÄ	ä
PROPN_HÄMET	t
PROPN_HAMMAS	mmas
PROPN_HÄMMINKI	nki
PROPN_HÄNNÄT	nnät
PROPN_HÄNTÄ	ntä
PROPN_HAPPI	ppi
PROPN_HAPPO	ppo
PROPN_HÄRKIN	n
PROPN_HEITIN	tin
PROPN_HENKI	nki
PROPN_HEPO	po
PROPN_HIIRI	i
PROPN_HIRTTO	tto
PROPN_HIUTALEET	eet
PROPN_HÖLKKÄ	kkä
PROPN_HONKA	nka
PROPN_HOPEAT	eat
PROPN_HÖPÖTTÄJÄ	ä
PROPN_HORTA	rta
PROPN_HOUSUT	ut
PROPN_HÖYHENET	et
PROPN_HUOLITELTU	ltu
PROPN_HUPI	pi
PROPN_HYLKY	ky
PROPN_HYÖTYY	yy
PROPN_INGET	nget
PROPN_ITÄMAAT	aat
PROPN_JÄÄTELÖ	ö
PROPN_JÄRJESTÖT	öt
PROPN_JÄRKI	ki
PROPN_JÄRVITAHDON	don
PROPN_JEPPE	ppe
PROPN_JOCKEY
PROPN_JOUKOT	ot
PROPN_JOUTSEN
PROPN_JUHLAT	at
PROPN_JUOVAT	vat
PROPN_JYLKYT	kyt
PROPN_KÄÄNTÖ	ntö
PROPN_KAARET	et
PROPN_KAARRET	rret
PROPN_KAARROT	rrot
PROPN_KÄKI	ki
PROPN_KALATOIN	toin
PROPN_KÄMMEKKÄ	kkä
PROPN_KANAALI	i
PROPN_KANGASALA	a
PROPN_KANGAS	ngas
PROPN_KANKAHAT	hat
PROPN_KANNEL	nnel
PROPN_KÄPÄLÄ	ä
PROPN_KÄPY	py
PROPN_KÄRÄJÄT	ät
PROPN_KÄRJET	jet
PROPN_KARRAT	rrat
PROPN_KÄRRY	[YÜyÿü]
PROPN_KÄRSÄKÄS	käs
PROPN_KÄSITE	e
PROPN_KASTANJETIT	tit
PROPN_KASTIKE	ke
PROPN_KASTILJAT	at
PROPN_KAUSI	si
PROPN_KEHVELI	i
PROPN_KENGÄT	ngät
PROPN_KENKÄ	nkä
PROPN_KENTÄT	tät
PROPN_KENTTÄ	ttä
PROPN_KERITSIMET	met
PROPN_KERTA	rta
PROPN_KEVÄT	t
PROPN_KIDE	de
PROPN_KIELTO	lto
PROPN_KIERRE	rre
PROPN_KIHARAT	at
PROPN_KIINNE	nne
PROPN_KILPI	pi
PROPN_KINNAS	nnas
PROPN_KIRITTÄRET	ttäret
PROPN_KIRJA	a
PROPN_KIRVES	es
PROPN_KITARA	a
PROPN_KIVI	i
PROPN_KLUMPIT	pit
PROPN_KOE	e
PROPN_KOKO	ko
PROPN_KOMPA	mpa
PROPN_KÖNGÄS	ngäs
PROPN_KÖÖ	öö
PROPN_KORPI	pi
PROPN_KORTES	tes
PROPN_KORTET	tet
PROPN_KORTTI	tti
PROPN_KORVET	vet
PROPN_KOUVOT	ot
PROPN_KÖYHYYS	ys
PROPN_KÖYSI	si
PROPN_KREUS	us
PROPN_KUITU	tu
PROPN_KUMMUT	mmut
PROPN_KUNGFU
PROPN_KUNNAT	nnat
PROPN_KUNTA	nta
PROPN_KUOPAT	pat
PROPN_KUOPPA	ppa
PROPN_KUPPI	ppi
PROPN_KUTSUNTA	nta
PROPN_KUULOKKEET	keet
PROPN_KUUS	s
PROPN_KYDÖT	döt
PROPN_KYKY	yky
PROPN_KYLÄNVANHIN	n
PROPN_KYLKIÄINEN	nen
PROPN_KYNNÄÄT	äät
PROPN_KYNNET	nnet
PROPN_LÄÄKE	ke
PROPN_LAET	et
PROPN_LÄHDES	des
PROPN_LAHDET	det
PROPN_LÄHDET	det
PROPN_LÄHIN	in
PROPN_LAHTI	ti
PROPN_LAIDUN	dun
PROPN_LAKI	ki
PROPN_LAMMET	mmet
PROPN_LAMMI	mpi
PROPN_LAMMIT	mmit
PROPN_LANKA	nka
PROPN_LANNET	nnet
PROPN_LÄNSI	nsi
PROPN_LASIT	t
PROPN_LEHDET	det
PROPN_LEHTI	ti
PROPN_LEIKKUU	uu
PROPN_LEIPÄ	pä
PROPN_LENTTEE	ee
PROPN_LEPAKKO	kko
PROPN_LIEMI	mi
PROPN_LIITTOUTUNEET	neet
PROPN_LIIVIT	it
PROPN_LINGOT	ngot
PROPN_LINTU	ntu
PROPN_LIPEÄ	eä
PROPN_LIPOTTARET	ttaret
PROPN_LIPPU	ppu
PROPN_LIUKU	uku
PROPN_LIVVADIEVÁT	át
PROPN_LOKA	ka
PROPN_LOKKI	kki
PROPN_LOMMOL	mol
PROPN_LÖPÖ	pö
PROPN_LOTTE	tte
PROPN_LOUET	uet
PROPN_LUHDAT	dat
PROPN_LUKU	uku
PROPN_LUMME	mme
PROPN_LUODE	de
PROPN_LUODES	des
PROPN_LUOKKA	kka
PROPN_LUOLIKOT	kot
PROPN_LUPA	pa
PROPN_LUSIKKA	kka
PROPN_MAA	aa
PROPN_MÄET	et
PROPN_MAKKARA	a
PROPN_MAKU	ku
PROPN_MALKO	ko
PROPN_MALMÖ
PROPN_MÄNNYT	nnyt
PROPN_MÄNTY	nty
PROPN_MARKKINAT	at
PROPN_MATEE	e
PROPN_MATKUET	et
PROPN_MÄTTÄÄT	ttäät
PROPN_MC	.
PROPN_MERI	i
PROPN_MERTU	rtu
PROPN_METTE	tte
PROPN_MIEHET	iehet
PROPN_MIELENGE	nge
PROPN_MIELLE	lle
PROPN_MIES	ies
PROPN_MITTA	tta
PROPN_MÖMMÖ	ö
PROPN_MONSIEUR
PROPN_MÖRKÖ	kö
PROPN_MULTA	lta
PROPN_MURTEET	rteet
PROPN_MYRKKY	kky
PROPN_NÄKY	ky
PROPN_NÄLKÄ	kä
PROPN_NALLE	[Eeëěĕ]
PROPN_NEUVOTTELUT	ut
PROPN_NIEMET	et
PROPN_NIHTI	ti
PROPN_NIITUT	tut
PROPN_NIITYT	tyt
PROPN_NIMETÖIN	töin
PROPN_NIMETÖN	tön
PROPN_NISSE	[Eeěë]
PROPN_NOKI	ki
PROPN_NOUGAT
PROPN_NUGAA	aa
PROPN_NUKKE	kke
PROPN_OLUT	ut
PROPN_ONKI	ki
PROPN_ONNET	net
PROPN_ONNI	i
PROPN_OOKOO	oo
PROPN_OPINNOT	nnot
PROPN_OSATON	ton
PROPN_OSOITE	e
PROPN_PÄÄ	ää
PROPN_PAIKAT	at
PROPN_PANKIT	kit
PROPN_PARFAIT
PROPN_PATA	ta
PROPN_PATEE	ee
PROPN_PATSAS	as
PROPN_PEIPOT	pot
PROPN_PELKO	ko
PROPN_PELTI	lti
PROPN_PENGER	nger
PROPN_PIDOT	dot
PROPN_PII	i
PROPN_PIIROA	[ôo]a
PROPN_PIPPALOT	ot
PROPN_PISTE
PROPN_POHATTA	tta
PROPN_POHJE	je
PROPN_POIKA	oika
PROPN_POJAT	ojat
PROPN_PÖKSYT	yt
PROPN_PÖLHÄÄT	äät
PROPN_POLITIIKKA	kka
PROPN_PÖLLÖT	öt
PROPN_PONSI	nsi
PROPN_PÖNTTÖ	ttö
PROPN_PORRAS	rras
PROPN_PORTAAT	rtaat
PROPN_PÖYTÄ	tä
PROPN_PROBLEEMA	a
PROPN_PUHELIN	n
PROPN_PUNK	.
PROPN_PUUT	uut
PROPN_PUU	u
PROPN_PYHTÄÄ	ää
PROPN_PYTTY	tty
PROPN_PYY	yy
PROPN_RAGUU	uu
PROPN_RÄJÄYTYS	s
PROPN_RAKENNE	ne
PROPN_RÄMEÄT	eät
PROPN_RÄMEET	eet
PROPN_RÄMIÄT	ät
PROPN_RAMPA	mpa
PROPN_RANGAT	ngat
PROPN_RANNAT	nnat
PROPN_RAPPE	ppe
PROPN_RAPPUSET	set
PROPN_RAPUT	put
PROPN_RATAS	tas
PROPN_RAUDAT	dat
PROPN_RAUNIOT	ot
PROPN_RAVUT	vut
PROPN_REGGAE
PROPN_REIÄT	ät
PROPN_REIKÄ	kä
PROPN_RENKAAT	kaat
PROPN_RIIPI	pi
PROPN_RIIVET	vet
PROPN_RIMMI	mpi
PROPN_RIMMIT	mmit
PROPN_RIMPI	mpi
PROPN_RINNET	nnet
PROPN_RINTEET	nteet
PROPN_RIPE	pe
PROPN_RIPSET	et
PROPN_RIUTAT	tat
PROPN_ROITOT	tot
PROPN_ROMPAAT	paat
PROPN_ROSÉ
PROPN_ROTTA	tta
PROPN_RUIPELO	o
PROPN_RUIS	is
PROPN_RUMPU	mpu
PROPN_RUNKO	nko
PROPN_RUOKO	oko
PROPN_RUOPPAAT	ppaat
PROPN_RUUHI	i
PROPN_RUUMIS	is
PROPN_RUUVI	i
PROPN_RYPÄS	päs
PROPN_RYYPPY	ppy
PROPN_SÄÄDIN	din
PROPN_SAAPAS	pas
PROPN_SAARET	et
PROPN_SÄÄRET	et
PROPN_SAKSET	et
PROPN_SALONTEET	nteet
PROPN_SALPA	pa
PROPN_SAMMALET	et
PROPN_SAMPI	mpi
PROPN_SAMPO	mpo
PROPN_SÄNKY	nky
PROPN_SÄRKÄT	kät
PROPN_SEIKKAILU	u
PROPN_SEIVÄS	väs
PROPN_SELENE
PROPN_SELJÄT	jät
PROPN_SEPPÄ	ppä
PROPN_SERGEJ	j
PROPN_SERKUKSET	kset
PROPN_SHOW
PROPN_SIEMEN
PROPN_SIIRTO	rto
PROPN_SIIVILÄ	ä
PROPN_SILAKAT	kat
PROPN_SILMÄKKEET	keet
PROPN_SISÄLTÖ	ltö
PROPN_SIUNAAMATTOMAT	ttomat
PROPN_SIVISTYNYT	nyt
PROPN_SKEITTI	tti
PROPN_SOINTI	nti
PROPN_SOKEA	ea
PROPN_SOTA	ta
PROPN_SPOTIFY
PROPN_STADION	.
PROPN_SUHTEET	teet
PROPN_SUKAT	kat
PROPN_SULKA	ka
PROPN_SUODATIN	tin
PROPN_SUOT	uot
PROPN_SYDÄN	n
PROPN_SYLI	i
PROPN_SYÖMINGIT	ngit
PROPN_TAIMI	mi
PROPN_TAIVAL	val
PROPN_TALKOOT	oot
PROPN_TALO	[Oo]
PROPN_TARVE	ve
PROPN_TAUDIT	dit
PROPN_TAUTI	ti
PROPN_TAVAT	vat
PROPN_TEE	[ée]e
PROPN_TEHDAS	das
PROPN_TEHTAAT	taat
PROPN_TEKO	ko
PROPN_TIE	ie
PROPN_TIENOO	oo
PROPN_TIETEET	teet
PROPN_TIHVII	ii
PROPN_TIKKAAT	kaat
PROPN_TIKKU	kku
PROPN_TIPPA	ppa
PROPN_TOIMET	et
PROPN_TOKEE	ee
PROPN_TÖLPÄKÖT	köt
PROPN_TÖLPÄT	pät
PROPN_TONGIT	git
PROPN_TÖRPPÖ	ppö
PROPN_TORTTU	tu
PROPN_TOULAT	at
PROPN_TRIKOO	oo
PROPN_TULI	i
PROPN_TUNTO	nto
PROPN_TUOMIO	o
PROPN_TYÖTTÖMÄT	ttömät
PROPN_TYÖ	yö
PROPN_TYTÄR	tär
PROPN_TYTÖT	töt
PROPN_TYYLI	i
PROPN_TYYPPI	ppi
PROPN_UKKO	kko
PROPN_ULAPPA	ppa
PROPN_VAADIN	din
PROPN_VAAKA	ka
PROPN_VAANII	i
PROPN_VAASAN
PROPN_VAINAA	aa
PROPN_VAKUUTUS	s
PROPN_VALJAAT	aat
PROPN_VALLAT	llat
PROPN_VALTA	lta
PROPN_VANHEMMAT	mmat
PROPN_VANKI	nki
PROPN_VARAS	as
PROPN_VARAT	at
PROPN_VARPAAT	paat
PROPN_VARSI	rsi
PROPN_VÄRTÖ	rtö
PROPN_VARVAS	vas
PROPN_VEHKEILY	y
PROPN_VEITSI	tsi
PROPN_VELJET	eljet
PROPN_VERSAILLES
PROPN_VETO	to
PROPN_VETY	ty
PROPN_VIENTI	nti
PROPN_VIHKIÄISET	set
PROPN_VIIRRET	rret
PROPN_VIIS	s
PROPN_VIIVE	ve
PROPN_VIKA	ka
PROPN_VINKU	nku
PROPN_VIRSI	rsi
PROPN_VODĂ	ă
PROPN_VOIMA	a
PROPN_VON	.
PROPN_VUODET	det
PROPN_VUOLLE	lle
PROPN_VUOLLET	llet
PROPN_VUO	uo
PROPN_YHTIÖT	t
PROPN_YKSIKKÖ	kkö
PROPN_YLÄNKÖ	nkö
PROPN_YLÖÖ	öö
PROPN_YMPÄRYSTÄ	ä
PROPN_YÖKKÖ	kkö
PROPN_YRITTÄ	ttä
PROPN_YSTÄVYKSET	kset
PROPN_ZEN	.
PROPN_ZOMBIE	e
PUNCT_NONSTD_DASH_LOOP	.
PUNCT_NONSTD_EXCL_LOOP	.
PUNCT_PILKKU	.
PUNCT_PISTE	.
SCONJ_ETTÄ	.
SYM_,	.
SYM_.	.
SYM_§	.
SYM_¢	.
SYM_$	.
SYM_£	.
SYM_€	.
SYM_CELSIUS	.
SYM_GRAMMA	.
SYM_JOULE	.
SYM_METRI	.
SYM_TUOTE	.
SYM_WEBER	.
SYM_Ω	.
VERB_AALLOTA	llota
VERB_ÄHKÄÄ	ää
VERB_AHNEHTIA	tia
VERB_ÄKSYILLÄ	llä
VERB_ÄLLISTYÄ	yä
VERB_AMPUA	pua
VERB_ÄNGETÄ	ngetä
VERB_ÄRISTÄ	stä
VERB_ARVAILLA	illa
VERB_ARVATA	ta
VERB_AUTTAA	ttaa
VERB_DIGATA	gata
VERB_EHTIÄ	tiä
VERB_EI	ei
VERB_ENTÄÄ	ntää
VERB_ERATA	ata
VERB_ETUILLA	lla
VERB_HALAJAA	ata
VERB_HALJETA	jeta
VERB_HALUTA	uta
VERB_HAPATA	pata
VERB_HARPPOA	ppoa
VERB_HAUKKOA	kkoa
VERB_HÄVÄISTÄ	väistä
VERB_HELÄJÄÄ	äjää
VERB_HELLITÄ	litä
VERB_HELPOTA	pota
VERB_HERÄTELLÄ	tellä
VERB_HERMOTTUA	ttua
VERB_HIIPUA	pua
VERB_HIVENTÄÄ	ntää
VERB_HUMALTUA	tua
VERB_HUONONTAA	ntaa
VERB_HUUTAA	taa
VERB_HYLJÄTÄ	jätä
VERB_HYLKIÄ	kiä
VERB_HYPELLÄ	pellä
VERB_HYPPIÄ	ppiä
VERB_ILJETÄ	jetä
VERB_INNOTA	nnota
VERB_IRROTA	rrota
VERB_ISÄNNÖIDÄ	öidä
VERB_JÄÄDÄ	äädä
VERB_JAHDATA	data
VERB_JOUTAA	taa
VERB_JUOSTA	sta
VERB_JYRKETÄ	etä
VERB_KÄÄNNELLÄ	nnellä
VERB_KAATAA	taa
VERB_KAIKOTA	ota
VERB_KAIVATA	vata
VERB_KALPPIA	ppia
VERB_KAMMETA	mmeta
VERB_KANTAA	ntaa
VERB_KARHETA	ta
VERB_KARHUTA	ta
VERB_KÄRKKYÄ	kkyä
VERB_KASVAA	aa
VERB_KAUNISTUA	ua
VERB_KAVETA	veta
VERB_KÄYDÄ	äydä
VERB_KERETÄ	etä
VERB_KERITÄ	itä
VERB_KIERTYÄ	rtyä
VERB_KIETOA	toa
VERB_KIHERRELLÄ	rrellä
VERB_KIILLELLÄ	lellä
VERB_KIINNETÄ	nnetä
VERB_KIITÄÄ	tää
VERB_KIRVOTA	vota
VERB_KIVETÄ	vetä
VERB_KIVETTYÄ	ttyä
VERB_KIVISTÄÄ	ää
VERB_KIVUTA	vuta
VERB_KOMENNELLA	nnella
VERB_KONTIA	ntia
VERB_KOPIOIDA	ida
VERB_KORVETA	veta
VERB_KOSIA	ia
VERB_KOUKUTA	kuta
VERB_KUHERTAA	taa
VERB_KUKKIA	kia
VERB_KUMMUTA	mmuta
VERB_KUTEA	tea
VERB_KYNTÄÄ	ntää
VERB_KYTKEÄ	eä
VERB_LÄHTEÄ	hteä
VERB_LÄMMETÄ	mmetä
VERB_LÄMMITÄ	mmitä
VERB_LÄNTÄTÄ	tätä
VERB_LASSOTA	ta
VERB_LEIKELLÄ	kellä
VERB_LEPÄILLÄ	illä
VERB_LEPPYÄ	ppyä
VERB_LEUDOTA	dota
VERB_LEVÄTÄ	vätä
VERB_LIIDUTA	duta
VERB_LOBATA	bata
VERB_LOITOTA	tota
VERB_LOPPUA	ppua
VERB_LOTOTA	tota
VERB_LUNTATA	tata
VERB_LUUTUTA	tuta
VERB_MÄDÄTÄ	dätä
VERB_MÄIKYÄ	kyä
VERB_MARISTA	sta
VERB_MAUKUA	ukua
VERB_MELLAKOIDA	oida
VERB_MENNÄ	nnä
VERB_MERKITÄ	itä
VERB_MIELTYÄ	ltyä
VERB_MIETTIÄ	ttiä
VERB_MOITTIA	ttia
VERB_MOJAHTAA	taa
VERB_MÖNKIÄ	nkiä
VERB_MORKATA	ata
VERB_MULLATA	llata
VERB_MUODOTA	dota
VERB_MUTRISTAA	aa
VERB_MYYDÄ	yydä
VERB_NÄHDÄ	hdä
VERB_NAKELLA	ella
VERB_NAKERRELLA	rrella
VERB_NÄPERTÄÄ	rtää
VERB_NIUKETA	eta
VERB_NUOKKUA	kua
VERB_OLLA	olla
VERB_OMMELLA	mmella
VERB_ONKIA	nkia
VERB_ÖYKKÄRÖIDÄ	öidä
VERB_PALKITA	ita
VERB_PANNA	nna
VERB_PÄTEÄ	teä
VERB_PEITOTA	tota
VERB_PENKOA	nkoa
VERB_PIDETÄ	detä
VERB_PIERRÄ	rrä
VERB_PIESTÄ	stä
VERB_PINGOTA	gota
VERB_POIKETA	eta
VERB_POLKEA	kea
VERB_PUKEA	kea
VERB_PULPUTA	puta
VERB_PUNOA	oa
VERB_PURKAA	kaa
VERB_PUSERTUA	rtua
VERB_PYYTÄÄ	tää
VERB_RAAPIA	pia
VERB_RAIKAA	aa
VERB_RANGAISTA	ngaista
VERB_RÄPSYTTÄÄ	ttää
VERB_RENNOTA	nnota
VERB_REVETÄ	vetä
VERB_RIIPIÄ	piä
VERB_ROHJETA	jeta
VERB_ROHTUA	tua
VERB_RYNNÄTÄ	nnätä
VERB_RYÖPYTÄ	pytä
VERB_RYPEÄ	peä
VERB_RYSKIÄ	iä
VERB_SAADA	aada
VERB_SAARTAA	rtaa
VERB_SÄILÖÄ	öä
VERB_SAMMOTA	mmota
VERB_SÄPSÄHDELLÄ	dellä
VERB_SÄRKEÄ	keä
VERB_SATAA	taa
VERB_SELVITÄ	tä
VERB_SIEPATA	pata
VERB_SILIYTYÄ	tyä
VERB_SILPOA	poa
VERB_SIVALTAA	taa
VERB_SÖRKKIÄ	kiä
VERB_SORTAA	taa
VERB_SOTKEA	ea
VERB_SULATELLA	tella
VERB_SUPETA	peta
VERB_SURRA	rra
VERB_SUUNNATA	nata
VERB_SYÖDÄ	yödä
VERB_SYÖPYÄ	pyä
VERB_TÄHDÄTÄ	dätä
VERB_TÄHYTÄ	tä
VERB_TAITAA	taa
VERB_TAKOA	koa
VERB_TAPELLA	pella
VERB_TAPPAA	ppaa
VERB_TEMMATA	mmata
VERB_TEMPOA	mpoa
VERB_TIETÄÄ	tää
VERB_TIPAHDELLA	della
VERB_TODETA	deta
VERB_TUIKKAA	kkaa
VERB_TULLA	lla
VERB_TUNGETA	ngeta
VERB_TUNKEA	nkea
VERB_TUNTEA	ntea
VERB_TUODA	uoda
VERB_TYHJENTYÄ	ntyä
VERB_TYLPETÄ	petä
VERB_TYMPIÄ	mpiä
VERB_ULOTA	ota
VERB_UPOTA	pota
VERB_VAAHDOTA	dota
VERB_VAELLELLA	llella
VERB_VÄHETÄ	etä
VERB_VAKAANTUA	ntua
VERB_VÄLPÄTÄ	pätä
VERB_VÄNGÄTÄ	gätä
VERB_VARTOA	rtoa
VERB_VAVISTA	vista
VERB_VERRATA	rrata
VERB_VIEDÄ	iedä
VERB_VIEROITTAA	ttaa
VERB_VIHELTÄÄ	ltää
VERB_VIITTOA	ttoa
VERB_VINKUA	nkua
VERB_VIPAJAA	aa
VERB_VIRKKAA	kaa
VERB_VONGATA	ngata
VERB_VYYHDETÄ	detä
VERB_YLTÄÄ	ltää
VERB_YNNÄTÄ	tä
VERB_YÖKÄTÄ	ätä
VERB_YSKÄHTÄÄ	tää
X_51äläkä	äläkä
X_51eikä	eikä
X_51ettei	ei
X_51ettei	ei
X_FORGN_EN	.
X_FORGN_SV	.
